Date,Income,Expenses,Department,Region,Customer_Satisfaction_Score,Transaction_Count,Profit
2021-09-06,13967,8656,HR,South,4,258,5311
2022-10-27,37488,17709,Operations,North,1,298,19779
2021-11-06,23211,11786,Sales,North,6,52,11425
2023-12-13,31169,5693,Sales,North,2,38,25476
2021-02-23,40373,26185,Finance,East,4,387,14188
2020-10-02,42669,13209,Sales,South,5,153,29460
2021-08-30,16634,8709,Operations,South,8,333,7925
2021-07-24,10840,24154,Marketing,West,3,216,-13314
2020-03-30,44229,22414,Operations,West,6,446,21815
2020-10-08,31318,25859,Operations,East,1,223,5459
2023-04-09,25405,19843,IT,North,9,143,5562
2021-09-29,46240,9209,Sales,West,1,454,37031
2022-03-21,25847,28379,HR,South,2,105,-2532
2023-10-10,33547,19846,Finance,West,1,10,13701
2023-05-12,16575,23003,Marketing,North,8,457,-6428
2023-08-05,40123,15088,HR,East,4,242,25035
2022-05-17,14843,23900,IT,North,2,489,-9057
2021-04-06,37451,17380,IT,West,7,376,20071
2022-01-19,17739,14707,Marketing,East,8,383,3032
2023-04-11,24852,29379,HR,East,9,114,-4527
2020-10-27,19157,22509,Marketing,North,5,233,-3352
2021-08-22,32406,11906,Marketing,West,3,69,20500
2021-06-12,17432,20895,Sales,North,1,365,-3463
2020-05-19,28837,26988,HR,West,8,44,1849
2020-10-04,25148,24420,Sales,West,6,169,728
2021-10-24,21194,23910,Sales,South,5,211,-2716
2021-05-25,42591,20212,Finance,East,7,276,22379
2023-10-01,24819,19323,Sales,West,5,481,5496
2023-03-09,16625,5166,Operations,North,4,107,11459
2020-04-23,17404,25573,IT,North,5,421,-8169
2021-08-02,24674,12348,IT,South,7,479,12326
2023-10-21,20507,5575,Operations,South,6,167,14932
2021-11-21,30387,12171,Marketing,South,9,205,18216
2021-09-28,28697,20748,HR,East,2,119,7949
2023-11-21,47391,8343,HR,South,7,486,39048
2022-04-02,29547,23202,HR,East,1,109,6345
2022-05-24,33570,14347,Sales,South,8,454,19223
2022-07-28,49783,27407,HR,East,4,239,22376
2022-07-30,38037,14727,HR,West,8,8,23310
2023-02-08,40083,15925,HR,South,8,43,24158
2020-12-23,47982,12979,IT,East,4,394,35003
2023-06-15,49706,14154,Operations,West,4,297,35552
2020-01-03,12988,26555,Finance,South,5,132,-13567
2021-02-07,15156,10409,Marketing,West,7,206,4747
2020-01-25,48280,9541,Operations,South,6,388,38739
2021-05-23,19788,27764,HR,North,1,280,-7976
2021-11-26,24185,25244,Marketing,East,6,239,-1059
2020-03-01,28734,22898,Marketing,North,3,277,5836
2020-05-02,19971,6067,Operations,East,9,394,13904
2020-02-24,16487,22265,Operations,North,3,46,-5778
2023-04-01,30997,11909,Operations,South,9,473,19088
2022-08-31,22452,26416,Finance,North,5,198,-3964
2022-11-28,25372,19236,Operations,South,8,464,6136
2023-01-11,23434,27886,Finance,East,9,121,-4452
2021-06-29,22416,25023,Sales,South,9,300,-2607
2020-04-22,29248,15929,IT,North,7,220,13319
2021-02-28,38194,25941,Finance,West,1,356,12253
2022-07-06,43785,13292,IT,East,8,289,30493
2020-08-17,47458,20319,HR,West,7,94,27139
2023-07-30,18373,24916,Sales,West,4,292,-6543
2022-07-05,40283,7816,Marketing,West,6,153,32467
2023-08-03,39415,11411,Operations,West,2,13,28004
2020-06-03,36414,20721,HR,West,4,423,15693
2020-06-13,24378,21791,Marketing,North,8,207,2587
2022-08-19,28336,12204,IT,South,4,255,16132
2023-04-20,14700,23899,Marketing,South,4,422,-9199
2023-06-16,23901,29517,Operations,West,4,158,-5616
2021-10-10,34838,6739,Operations,North,9,270,28099
2023-09-24,32597,9052,Finance,West,2,306,23545
2022-07-26,43428,21642,Finance,West,7,68,21786
2021-05-26,45687,10786,IT,East,3,257,34901
2022-07-20,39493,17013,Operations,North,4,189,22480
2020-09-22,41852,17596,Sales,West,1,3,24256
2020-07-05,20932,25067,HR,South,3,237,-4135
2022-11-29,33009,9720,IT,East,2,434,23289
2021-01-25,43583,19445,IT,West,7,445,24138
2023-07-07,37994,8726,Marketing,West,6,420,29268
2021-10-16,39865,5678,IT,West,1,132,34187
2020-06-24,22289,18029,HR,North,8,171,4260
2022-02-12,38293,14098,Sales,West,9,270,24195
2022-02-02,14734,13459,Marketing,South,1,89,1275
2023-09-14,30013,11126,HR,East,5,103,18887
2022-07-19,45521,18227,Finance,North,7,125,27294
2023-05-08,16505,9906,IT,East,2,67,6599
2021-12-11,14685,12898,Operations,South,6,263,1787
2023-05-04,28409,22584,Finance,West,8,8,5825
2022-04-05,29517,19439,Operations,North,8,44,10078
2021-08-11,40475,26739,HR,West,8,448,13736
2021-06-14,46989,6116,Sales,North,6,135,40873
2022-12-21,25327,11344,Operations,West,6,248,13983
2023-09-12,13671,27314,HR,South,3,304,-13643
2020-10-07,14941,14090,Marketing,South,2,318,851
2020-08-14,36372,18212,IT,West,5,25,18160
2021-09-30,22466,19078,Sales,South,9,465,3388
2022-12-17,28286,15836,Sales,West,4,474,12450
2022-07-09,14588,22442,Marketing,North,5,374,-7854
2021-04-21,38080,28668,Sales,South,6,196,9412
2023-10-31,34544,22071,HR,North,6,192,12473
2021-12-16,20811,26961,Sales,West,4,369,-6150
2020-08-30,28733,26974,Sales,North,4,402,1759
2021-01-01,49888,13152,Sales,East,8,122,36736
2022-07-24,40059,28447,HR,West,5,260,11612
2022-04-17,47487,13979,Finance,South,5,401,33508
2023-06-29,24550,17686,IT,South,9,47,6864
2022-06-24,20864,15836,Operations,East,4,374,5028
2023-09-07,35394,15356,Finance,West,7,209,20038
2021-01-10,29061,13395,Sales,West,5,301,15666
2023-12-03,22624,7491,Marketing,West,9,89,15133
2021-12-11,34934,26206,Marketing,West,8,442,8728
2020-12-08,13361,18928,HR,North,8,3,-5567
2020-08-27,23707,12004,IT,West,3,396,11703
2020-05-18,11924,16560,Sales,North,9,475,-4636
2023-02-19,39487,12011,HR,North,8,145,27476
2021-02-23,22647,27084,Operations,South,3,374,-4437
2020-10-30,41734,16750,IT,West,1,22,24984
2020-04-24,39018,9862,IT,North,5,39,29156
2020-12-08,31627,10350,HR,West,4,295,21277
2023-06-28,31031,17682,Finance,East,8,107,13349
2020-01-07,49449,17535,Marketing,North,6,496,31914
2021-12-31,12701,16703,Finance,South,5,100,-4002
2020-06-27,26719,14611,IT,West,9,272,12108
2023-03-14,19718,20096,Marketing,South,6,229,-378
2021-02-19,10056,19106,IT,North,3,435,-9050
2021-10-27,25352,5355,IT,North,6,374,19997
2023-02-18,13147,24856,IT,South,4,285,-11709
2023-02-21,13537,13432,Operations,West,5,206,105
2020-05-29,32812,20700,Marketing,North,6,71,12112
2021-01-31,10721,29094,Operations,East,9,169,-18373
2021-01-15,26769,18850,Marketing,South,3,185,7919
2022-04-18,24346,22238,Operations,North,1,412,2108
2020-01-01,49883,16935,Operations,West,2,333,32948
2020-08-31,20911,27747,Operations,North,8,208,-6836
2023-11-22,10259,11704,HR,West,4,405,-1445
2023-06-28,30872,25008,Operations,West,7,388,5864
2022-05-28,18791,20379,Finance,North,2,487,-1588
2023-08-15,17536,26830,Finance,East,8,382,-9294
2022-01-29,30432,14252,IT,West,9,355,16180
2022-08-11,42750,13573,Sales,South,7,372,29177
2023-08-13,29541,27415,Operations,West,1,271,2126
2022-09-03,26860,27566,Sales,West,2,437,-706
2023-02-12,15283,6132,Sales,East,9,346,9151
2020-01-01,40743,23860,IT,West,7,430,16883
2021-07-06,45127,24519,Sales,North,3,135,20608
2021-04-26,17405,20534,Sales,East,5,146,-3129
2021-08-22,41181,16030,Finance,West,1,345,25151
2022-02-01,42205,7079,Sales,North,3,485,35126
2020-11-30,34408,5944,Marketing,North,4,149,28464
2021-04-09,27645,10840,Operations,West,4,116,16805
2023-03-10,16323,25346,Operations,South,7,392,-9023
2021-08-05,15937,11674,Sales,South,5,187,4263
2020-05-16,40431,15721,IT,West,9,20,24710
2022-09-30,27882,17493,Marketing,West,7,338,10389
2022-08-07,35324,16510,IT,North,2,373,18814
2021-11-17,23003,5834,IT,West,8,467,17169
2020-06-15,35106,25134,Sales,West,2,244,9972
2023-09-28,22979,9184,HR,North,7,67,13795
2023-12-04,44977,12178,Sales,West,5,439,32799
2022-06-28,17228,10168,Finance,West,6,62,7060
2022-05-29,19300,9991,HR,West,4,486,9309
2022-04-21,18681,13146,Marketing,North,5,274,5535
2020-03-05,18267,18884,HR,West,5,347,-617
2022-12-26,15372,10290,Sales,South,7,463,5082
2021-03-08,48918,25622,Sales,West,4,110,23296
2022-12-09,20920,29782,IT,South,5,56,-8862
2023-08-30,26856,29549,Sales,West,4,85,-2693
2023-08-25,37785,24918,Finance,North,4,406,12867
2020-04-24,27221,19844,Sales,South,8,264,7377
2021-07-22,35178,23436,Operations,West,5,395,11742
2023-09-27,43954,13151,Operations,West,9,107,30803
2021-10-03,16461,5028,IT,West,5,12,11433
2021-05-09,27865,29763,HR,West,8,176,-1898
2023-07-16,24052,23244,HR,North,3,359,808
2022-07-29,40370,12934,Operations,East,7,319,27436
2023-01-08,17332,7572,Finance,South,1,27,9760
2023-08-15,10327,20281,Marketing,West,5,291,-9954
2022-08-25,32765,13051,Finance,North,2,130,19714
2022-04-01,15239,27512,Operations,East,8,227,-12273
2020-07-20,20078,25398,Finance,North,6,479,-5320
2021-10-10,17038,25636,Marketing,West,5,136,-8598
2021-07-13,18048,7127,HR,East,3,20,10921
2022-11-07,38671,15083,Operations,South,1,264,23588
2021-04-22,24954,24091,Sales,South,8,447,863
2021-05-02,45065,14933,Marketing,North,5,324,30132
2022-09-09,12779,20877,Marketing,South,9,159,-8098
2022-02-17,23225,6813,Marketing,South,7,160,16412
2020-12-05,42541,17519,HR,East,1,397,25022
2021-09-03,29720,12816,Finance,South,1,342,16904
2020-04-25,23531,13351,IT,East,7,26,10180
2020-03-14,15335,29919,Sales,East,7,81,-14584
2023-07-16,19530,20648,Operations,East,9,413,-1118
2020-04-25,34791,29780,Finance,South,2,475,5011
2023-04-02,11649,16234,Marketing,North,7,376,-4585
2023-05-30,23472,13496,HR,North,2,470,9976
2020-05-05,12862,17133,Marketing,South,2,18,-4271
2021-10-18,35185,13591,Finance,East,5,69,21594
2023-04-14,37134,16712,Operations,South,9,396,20422
2021-10-25,10917,11249,Sales,West,9,130,-332
2023-10-30,22444,20441,Marketing,North,1,426,2003
2022-09-17,30521,11485,HR,East,7,135,19036
2022-10-14,48217,14177,HR,South,3,303,34040
2022-05-08,32066,6805,IT,East,1,379,25261
2020-03-25,12811,26431,HR,West,2,218,-13620
2023-11-07,46189,26924,IT,East,6,310,19265
2021-09-24,19290,7096,Sales,West,2,487,12194
2021-03-26,45489,17493,Operations,North,2,15,27996
2021-06-01,37284,10337,IT,East,4,496,26947
2022-04-25,34698,21035,Marketing,South,3,186,13663
2021-11-25,29637,22843,Finance,East,8,417,6794
2021-07-03,43556,28318,Marketing,East,8,495,15238
2022-07-17,26640,14537,Operations,West,6,195,12103
2020-04-25,14025,13422,HR,West,4,191,603
2022-10-28,41476,8782,Finance,South,7,234,32694
2023-05-26,16741,18798,Marketing,North,9,432,-2057
2021-02-07,13654,24884,Finance,North,2,66,-11230
2020-10-30,46019,14074,IT,West,6,81,31945
2022-01-09,48036,26989,Operations,South,7,449,21047
2020-03-28,39843,11419,Marketing,East,1,36,28424
2022-10-30,33560,13624,HR,South,6,235,19936
2020-11-03,25987,12889,Finance,South,8,17,13098
2021-03-09,30810,15455,HR,South,7,2,15355
2022-03-12,30311,19432,Finance,North,2,33,10879
2020-06-12,44920,16194,Marketing,East,2,349,28726
2023-06-16,18738,26622,Operations,South,4,380,-7884
2023-09-02,17888,23201,Sales,North,5,134,-5313
2022-09-22,15474,12570,Marketing,North,5,427,2904
2021-10-17,10488,26487,HR,West,2,356,-15999
2023-09-20,34144,5617,Sales,East,7,344,28527
2020-01-18,15622,17684,Operations,South,8,267,-2062
2022-12-30,41830,13509,HR,East,2,5,28321
2023-04-13,46542,19717,Operations,West,4,286,26825
2022-03-21,49214,11285,Finance,West,3,394,37929
2020-12-04,37648,5456,Marketing,South,4,485,32192
2020-09-04,42697,5500,Operations,North,5,347,37197
2023-05-01,35223,29458,HR,West,6,91,5765
2023-12-13,31865,23699,Marketing,North,2,152,8166
2023-09-10,18572,8874,HR,West,6,443,9698
2020-11-01,33501,28014,HR,East,9,378,5487
2020-07-22,36866,9973,Sales,South,8,118,26893
2022-05-02,22416,9774,IT,West,1,451,12642
2023-02-20,35775,20519,Operations,East,9,61,15256
2021-03-22,39080,19349,Operations,West,2,358,19731
2021-12-13,14887,22387,Sales,South,1,26,-7500
2021-03-08,29374,28232,Finance,East,6,109,1142
2023-02-25,26605,25580,Operations,North,1,368,1025
2022-04-01,25684,28099,Sales,West,6,295,-2415
2022-12-06,34002,22450,Operations,West,2,210,11552
2021-05-19,36015,18622,Operations,East,7,259,17393
2020-04-24,32972,9716,HR,South,7,294,23256
2023-12-10,10617,14820,Sales,West,4,42,-4203
2022-09-21,45338,21087,Finance,East,2,304,24251
2020-08-10,16309,18302,Operations,South,7,473,-1993
2021-09-27,29139,27992,Finance,West,1,13,1147
2021-11-02,12790,8234,IT,East,2,89,4556
2022-08-15,17826,11494,Sales,South,2,88,6332
2022-07-21,22134,19239,Sales,West,1,312,2895
2020-04-05,29693,9498,Sales,West,9,489,20195
2020-04-16,14054,16430,HR,South,6,187,-2376
2021-09-23,26090,10267,Sales,South,3,63,15823
2021-11-28,33808,27555,HR,East,6,336,6253
2020-02-01,25569,17546,IT,West,7,43,8023
2020-03-06,42227,29479,Marketing,West,3,233,12748
2023-04-17,16508,8669,HR,East,4,234,7839
2022-02-17,26608,26099,Operations,West,1,75,509
2022-07-04,33523,14657,Sales,West,6,253,18866
2021-07-02,20433,27453,Marketing,West,6,313,-7020
2020-07-19,41939,6961,HR,North,9,149,34978
2020-02-18,34520,18940,Finance,South,2,479,15580
2022-02-25,21888,22259,Finance,North,5,182,-371
2022-08-08,40932,17093,Operations,North,5,207,23839
2020-09-19,29734,13734,Marketing,South,7,181,16000
2023-03-02,13827,8516,IT,North,5,173,5311
2020-12-09,26257,25249,HR,East,4,241,1008
2023-04-14,42194,20032,Finance,North,2,164,22162
2023-11-15,41318,25883,Finance,East,8,63,15435
2020-01-11,26793,12233,HR,South,5,382,14560
2020-07-19,44684,18170,Finance,West,4,235,26514
2022-08-02,38014,10947,IT,South,9,125,27067
2022-07-14,12859,21958,Finance,South,2,257,-9099
2020-01-03,49840,22842,HR,North,3,92,26998
2023-05-22,41856,12395,Sales,South,8,225,29461
2022-03-18,44819,8172,Finance,South,4,195,36647
2023-08-23,30085,23854,HR,East,9,375,6231
2021-07-13,18214,8427,Sales,West,9,207,9787
2023-09-12,45736,12798,Finance,North,9,417,32938
2020-07-17,10601,12736,Finance,West,1,288,-2135
2020-04-18,34318,20490,HR,West,6,215,13828
2023-08-07,25451,15707,Operations,West,6,186,9744
2020-04-17,15274,16743,Operations,North,8,126,-1469
2023-12-02,28226,9206,Marketing,South,7,282,19020
2021-07-05,40926,23584,Operations,West,7,255,17342
2022-08-30,29046,24348,IT,North,2,61,4698
2020-02-21,18674,28289,Marketing,South,4,368,-9615
2020-04-21,29023,8313,Operations,West,1,401,20710
2020-10-21,31910,20055,Sales,East,7,201,11855
2023-04-27,21503,24311,HR,North,4,69,-2808
2020-03-05,15368,13873,Operations,West,9,285,1495
2021-07-27,33527,29854,Sales,North,6,63,3673
2021-04-09,32487,9458,Marketing,East,6,134,23029
2020-09-14,46593,23032,HR,North,9,239,23561
2022-09-30,20391,26911,Operations,South,8,252,-6520
2021-09-25,19874,14350,Marketing,West,6,361,5524
2023-09-16,13608,13184,Operations,North,6,187,424
2020-07-28,40451,20865,Marketing,North,6,483,19586
2020-03-29,49646,7341,Operations,West,4,371,42305
2020-01-28,43786,22902,Sales,East,5,21,20884
2020-08-25,37546,6838,IT,East,3,429,30708
2020-12-01,45268,22254,Sales,West,9,429,23014
2020-03-03,12667,10538,HR,West,2,343,2129
2021-05-14,15230,16469,Operations,South,7,291,-1239
2022-03-01,35720,14533,IT,North,1,308,21187
2021-08-14,47602,10477,IT,North,7,46,37125
2022-12-10,11546,14363,HR,East,2,194,-2817
2023-02-09,25050,17264,HR,South,5,57,7786
2020-10-27,40134,18536,IT,North,1,42,21598
2023-01-18,25640,22512,HR,South,5,457,3128
2020-08-16,30828,16819,HR,West,4,333,14009
2020-05-29,24284,17191,Operations,North,1,235,7093
2023-03-07,13423,11499,Sales,West,1,354,1924
2023-03-04,38577,17079,Finance,East,7,16,21498
2021-06-10,29070,22668,Marketing,East,3,133,6402
2020-11-28,12332,13762,IT,West,9,1,-1430
2023-10-17,16066,24248,Marketing,East,9,232,-8182
2020-06-22,28040,11045,IT,West,9,150,16995
2023-05-21,48806,17176,IT,West,1,304,31630
2023-09-28,18583,16333,Sales,West,4,494,2250
2020-03-01,48057,23361,IT,East,1,122,24696
2022-12-20,32604,13638,IT,East,1,282,18966
2022-03-29,36564,18070,Sales,East,9,290,18494
2021-06-07,43064,10039,HR,West,5,370,33025
2020-08-03,32857,28423,Finance,South,1,314,4434
2021-09-15,38941,20265,Marketing,East,3,213,18676
2021-07-31,47962,7973,IT,South,7,391,39989
2021-11-24,48573,9626,Sales,East,2,281,38947
2021-02-26,35692,21502,IT,North,4,441,14190
2021-12-16,26879,12999,Sales,North,2,140,13880
2023-12-17,45763,7292,Marketing,North,9,159,38471
2023-10-26,26477,23488,Operations,South,9,495,2989
2023-05-14,16393,22451,HR,East,7,27,-6058
2023-08-02,43488,19859,Operations,West,7,342,23629
2023-02-02,31459,21807,Sales,South,2,162,9652
2022-01-23,49093,8819,IT,East,8,118,40274
2022-01-16,22554,29087,HR,North,1,337,-6533
2021-11-18,47867,17682,Marketing,South,8,75,30185
2021-12-23,22568,19785,Finance,East,5,93,2783
2022-01-16,46794,6280,HR,West,4,34,40514
2020-08-29,15057,18241,IT,South,2,115,-3184
2021-10-26,27490,15011,Operations,West,3,421,12479
2021-12-08,15305,19147,Sales,South,2,442,-3842
2021-03-10,42740,24816,Operations,North,4,113,17924
2022-02-19,34118,22146,HR,North,3,368,11972
2021-04-28,16674,6629,Finance,North,5,60,10045
2021-01-18,34998,10499,IT,West,7,282,24499
2020-06-18,25316,13634,Sales,North,9,237,11682
2022-10-17,26217,8014,IT,West,5,126,18203
2022-08-07,12005,15773,IT,West,8,429,-3768
2022-05-18,24602,22881,Finance,West,2,45,1721
2020-11-18,31645,13280,HR,North,6,288,18365
2022-04-27,23987,13653,Operations,East,8,229,10334
2023-06-09,23543,24936,IT,West,9,197,-1393
2021-11-26,37944,16820,IT,East,4,212,21124
2020-12-24,19144,12637,IT,West,4,499,6507
2023-07-22,48459,29955,Sales,North,7,71,18504
2020-02-01,49827,25880,IT,North,4,235,23947
2020-06-25,40741,18390,IT,North,5,279,22351
2022-07-05,14479,26030,HR,South,2,449,-11551
2020-03-05,14198,24367,IT,North,2,167,-10169
2020-01-27,19091,21155,Finance,East,5,195,-2064
2020-09-24,14205,8060,Finance,West,2,173,6145
2021-08-19,13641,18697,IT,East,6,195,-5056
2022-10-08,13543,20313,Finance,South,6,63,-6770
2020-03-06,15591,29218,HR,East,8,70,-13627
2020-05-12,39341,28188,Sales,West,1,223,11153
2022-07-04,39055,12510,Finance,West,7,310,26545
2023-10-21,16116,7950,Finance,North,7,283,8166
2020-03-22,10761,25924,Operations,South,9,349,-15163
2022-09-08,12407,19387,HR,South,4,79,-6980
2023-09-13,41594,28802,Finance,East,7,36,12792
2023-01-26,10885,11063,Sales,North,6,389,-178
2021-08-07,42195,19205,Operations,North,4,195,22990
2020-11-22,45411,16922,IT,North,8,435,28489
2021-06-25,37819,12661,HR,West,3,217,25158
2023-02-22,21125,8421,Finance,South,8,288,12704
2020-07-28,31494,6990,IT,East,5,149,24504
2020-05-12,44236,18057,HR,East,4,496,26179
2020-06-05,34585,25240,Operations,East,3,273,9345
2022-05-24,32045,6482,Finance,North,7,201,25563
2021-01-16,32447,7545,Sales,South,7,154,24902
2022-11-11,49783,9220,HR,South,6,22,40563
2022-08-31,36238,17491,Sales,West,3,297,18747
2021-08-17,49091,5642,IT,West,9,494,43449
2023-12-13,45196,18332,IT,West,2,315,26864
2021-04-16,21685,25302,Operations,East,3,215,-3617
2020-08-21,22738,6586,Operations,East,1,331,16152
2021-07-25,25772,23793,Marketing,South,7,122,1979
2022-02-09,20633,11504,Marketing,West,2,266,9129
2023-03-31,33492,21438,Operations,East,8,343,12054
2020-10-27,46855,19627,Finance,West,9,261,27228
2020-11-01,16228,22225,IT,West,2,55,-5997
2020-01-02,12831,11928,Sales,South,6,282,903
2020-09-27,30045,9587,Operations,South,1,260,20458
2021-02-24,28132,24290,Finance,East,8,363,3842
2023-03-12,21055,26472,Sales,South,5,283,-5417
2021-11-30,34318,15186,Marketing,West,9,230,19132
2022-05-13,23795,15124,Sales,South,3,482,8671
2022-08-17,29648,10056,Operations,West,2,126,19592
2022-09-20,32158,10982,IT,West,7,442,21176
2022-10-06,31747,7272,Operations,East,7,259,24475
2022-05-28,33234,11141,HR,East,5,50,22093
2021-11-22,41560,29399,Finance,East,7,224,12161
2022-05-16,21282,29678,Finance,West,6,381,-8396
2022-11-26,43831,14161,Finance,South,9,282,29670
2020-04-16,33043,6071,HR,East,3,146,26972
2023-08-13,30929,22120,HR,East,4,391,8809
2023-01-25,45500,11376,IT,South,9,373,34124
2020-10-07,11872,29133,Finance,South,8,45,-17261
2023-02-07,47488,8630,Operations,East,6,397,38858
2021-07-02,11969,5227,HR,West,3,262,6742
2021-07-05,35460,20342,Operations,West,9,419,15118
2020-07-06,22155,11665,Marketing,East,9,479,10490
2022-01-21,21870,19008,Finance,South,6,234,2862
2022-05-19,38392,27095,HR,West,2,53,11297
2023-10-09,13717,27540,HR,South,7,485,-13823
2020-01-19,11374,24954,IT,North,9,235,-13580
2022-05-08,31826,12993,Operations,South,9,196,18833
2023-11-17,18679,19675,IT,South,3,426,-996
2023-07-08,23427,6619,IT,North,2,4,16808
2022-09-11,33564,17885,Operations,West,5,60,15679
2021-02-13,44708,7204,Marketing,West,7,173,37504
2023-11-27,45135,24087,Operations,West,3,72,21048
2021-04-28,34271,12742,Marketing,East,4,486,21529
2023-08-20,26631,16694,IT,North,2,75,9937
2021-09-15,29887,16818,Marketing,South,2,322,13069
2021-10-17,35259,12574,Finance,North,7,466,22685
2022-02-06,42396,14373,Marketing,North,2,466,28023
2020-01-18,29144,16448,Marketing,North,1,22,12696
2020-07-02,22655,22181,HR,North,4,396,474
2021-02-08,30836,24383,HR,North,6,209,6453
2022-03-09,11368,7764,IT,North,4,51,3604
2023-02-28,44994,15601,Operations,East,1,145,29393
2021-04-23,46380,25068,Marketing,North,1,420,21312
2020-01-08,22199,16467,Finance,North,9,349,5732
2021-12-05,21569,13199,HR,West,1,305,8370
2023-09-03,43827,15411,Operations,North,7,272,28416
2023-11-15,41182,11239,Finance,North,7,489,29943
2023-03-05,23115,25258,Marketing,West,1,459,-2143
2021-06-14,31649,19943,Operations,West,1,44,11706
2022-07-01,28195,18617,Finance,West,6,107,9578
2023-10-22,40596,8329,Sales,South,8,493,32267
2021-11-19,44961,27453,Finance,North,7,150,17508
2022-10-31,37003,16563,Finance,North,6,94,20440
2021-07-06,26551,10584,Marketing,North,3,264,15967
2021-03-21,33826,13805,Operations,West,7,110,20021
2023-02-11,46950,14089,Marketing,East,6,18,32861
2021-12-06,34729,18639,Marketing,North,8,238,16090
2020-07-14,13868,29685,Sales,West,4,336,-15817
2022-05-09,48718,20488,Finance,West,9,239,28230
2023-09-08,42353,16110,Operations,West,1,374,26243
2021-09-19,40653,6160,IT,South,7,212,34493
2022-09-07,24141,17173,HR,West,9,231,6968
2021-09-21,21537,24994,Marketing,East,1,328,-3457
2023-04-03,40401,26128,Marketing,South,3,350,14273
2023-06-29,37387,12331,Marketing,West,7,294,25056
2020-02-13,26154,19684,Marketing,East,9,413,6470
2021-05-03,45077,23387,HR,East,1,461,21690
2020-06-29,16630,19798,IT,North,6,81,-3168
2023-01-05,24778,29419,Sales,West,2,255,-4641
2021-01-08,33070,6527,IT,West,5,232,26543
2021-09-19,23416,20220,HR,North,7,363,3196
2022-08-14,35399,28702,Operations,East,7,209,6697
2020-03-07,18629,15105,Sales,West,7,457,3524
2023-01-20,18360,18896,Sales,North,4,386,-536
2022-02-17,22011,18085,Operations,North,6,443,3926
2021-10-12,46069,20205,Finance,East,6,298,25864
2023-06-21,21227,28618,Marketing,East,7,374,-7391
2020-12-06,49587,26553,HR,West,9,472,23034
2022-06-21,12769,25994,Operations,West,6,21,-13225
2023-08-20,20492,28105,IT,South,1,238,-7613
2021-02-01,13345,25634,IT,East,8,386,-12289
2021-12-03,12665,15198,Finance,South,2,261,-2533
2020-04-06,34807,17398,Operations,South,3,273,17409
2023-09-16,22366,11626,HR,North,5,280,10740
2023-05-13,19325,7855,Finance,North,6,392,11470
2021-03-24,15440,8964,Finance,West,7,414,6476
2023-12-12,38222,29319,Finance,East,4,434,8903
2020-03-17,36951,19609,Sales,East,3,150,17342
2022-06-14,49878,19490,Sales,South,9,315,30388
2021-07-02,30264,23058,Marketing,South,4,152,7206
2022-03-08,29121,18330,HR,West,9,282,10791
2023-12-19,28815,7392,IT,North,9,61,21423
2023-12-23,40311,21262,IT,East,3,136,19049
2022-03-25,29749,11878,Marketing,East,3,12,17871
2022-10-18,39218,19904,IT,East,8,14,19314
2020-05-14,25533,6921,Finance,East,1,30,18612
2021-10-15,11316,15884,Marketing,North,6,439,-4568
2023-07-01,47972,9433,Marketing,West,6,355,38539
2023-07-02,31388,23211,Operations,West,9,445,8177
2021-10-07,23512,15691,Sales,North,2,318,7821
2021-12-20,10684,5716,HR,West,8,287,4968
2021-09-04,37164,22014,HR,West,7,220,15150
2021-04-28,49208,26244,Sales,South,2,238,22964
2022-12-05,21735,29660,Finance,North,1,27,-7925
2021-10-09,45855,8768,HR,West,4,484,37087
2022-03-02,48546,7707,IT,South,2,257,40839
2021-08-01,18079,21151,IT,North,3,297,-3072
2022-10-24,32412,29802,HR,North,2,142,2610
2020-01-01,45862,24741,Operations,East,9,250,21121
2023-08-06,29191,14499,HR,South,4,74,14692
2020-04-18,24821,29244,Marketing,South,1,434,-4423
2021-04-04,17582,21306,Finance,South,8,298,-3724
2020-09-22,19012,25588,Marketing,North,4,199,-6576
2023-03-07,43655,25614,Sales,East,8,296,18041
2023-12-28,48783,10033,Finance,North,8,14,38750
2020-02-13,24530,9386,Finance,West,9,100,15144
2022-06-04,30377,17150,IT,West,7,91,13227
2022-08-01,31653,13157,Finance,West,4,395,18496
2022-09-09,30380,19113,Operations,East,2,191,11267
2020-09-18,10556,20974,HR,North,6,362,-10418
2021-12-28,36790,12675,Marketing,South,4,305,24115
2021-09-24,18900,23251,IT,West,6,421,-4351
2020-05-31,43485,28349,IT,West,8,106,15136
2020-07-31,46433,28580,Operations,North,3,394,17853
2022-10-12,23891,21410,Operations,South,1,438,2481
2023-06-11,25014,20826,Operations,East,5,7,4188
2022-05-12,16547,27540,Operations,West,3,81,-10993
2021-09-14,47964,17841,Marketing,West,6,253,30123
2020-12-26,39932,14124,Operations,West,3,140,25808
2020-11-15,30263,11588,IT,South,1,485,18675
2020-08-09,29320,20822,IT,West,9,357,8498
2020-07-28,49459,27151,Finance,South,5,311,22308
2023-11-20,17045,21850,HR,West,2,420,-4805
2022-07-19,11237,29073,IT,West,2,7,-17836
2021-05-03,49240,18536,IT,South,9,152,30704
2021-08-23,46326,7700,Marketing,South,1,290,38626
2022-02-12,15293,13809,Finance,East,3,126,1484
2022-05-27,35274,20115,IT,North,7,449,15159
2021-11-30,29237,25161,Sales,West,1,285,4076
2021-03-27,38384,17745,IT,West,2,282,20639
2021-02-16,40993,24071,HR,North,6,74,16922
2021-04-20,22811,10332,HR,North,9,449,12479
2020-09-12,28229,28190,Finance,North,9,45,39
2023-03-19,49130,26440,Finance,West,8,17,22690
2020-05-06,23311,17159,Operations,West,3,233,6152
2021-01-26,33040,5179,Marketing,West,2,164,27861
2021-04-24,13182,12996,HR,South,1,457,186
2022-09-19,15760,15777,Sales,East,9,487,-17
2023-11-21,17260,19862,Sales,East,5,63,-2602
2022-07-11,43218,10464,Operations,North,3,407,32754
2021-02-05,11915,28104,Marketing,North,5,93,-16189
2020-09-30,19115,22305,Marketing,West,3,322,-3190
2022-04-24,17076,8092,Finance,East,9,466,8984
2020-05-18,24814,10527,IT,East,1,92,14287
2020-04-12,43083,16791,Sales,South,1,373,26292
2023-06-19,14793,18727,Sales,West,3,495,-3934
2023-02-14,11262,28849,Sales,West,6,42,-17587
2023-05-22,19319,7719,Sales,East,2,241,11600
2021-04-28,23194,29497,HR,East,1,327,-6303
2021-06-12,29309,20912,Marketing,South,8,255,8397
2020-08-11,38760,20467,IT,South,9,331,18293
2023-07-17,36998,17924,HR,West,1,71,19074
2023-03-03,13468,14215,Marketing,South,3,299,-747
2020-04-23,22651,21535,Operations,East,5,216,1116
2021-10-05,30405,29588,Sales,West,7,311,817
2021-10-12,24482,20241,IT,East,4,56,4241
2023-10-20,14409,25009,Marketing,West,6,79,-10600
2023-06-09,10547,29824,Operations,West,1,415,-19277
2021-04-02,47659,6144,Sales,East,4,499,41515
2021-01-09,29907,25866,Operations,West,8,339,4041
2021-09-02,33426,9534,Operations,West,5,440,23892
2020-07-25,24436,19635,HR,South,8,121,4801
2022-07-05,26490,5720,Operations,East,1,202,20770
2020-11-16,38962,25952,HR,East,9,432,13010
2020-04-02,48236,24613,Finance,South,4,436,23623
2023-12-02,39288,6006,HR,West,9,328,33282
2023-03-27,32236,26112,Operations,North,8,257,6124
2022-05-21,24923,16490,Marketing,North,8,130,8433
2020-04-08,11250,12099,Operations,East,2,349,-849
2020-08-12,23264,28500,Operations,South,3,42,-5236
2022-05-01,11611,17311,Marketing,West,9,74,-5700
2021-03-16,17928,25197,Sales,South,3,234,-7269
2021-12-20,44558,5537,IT,West,8,9,39021
2021-08-07,10867,20929,Finance,East,5,370,-10062
2023-11-25,41689,16016,Sales,East,7,31,25673
2020-03-04,43095,7685,Operations,North,4,96,35410
2022-02-06,13816,6980,Sales,South,8,258,6836
2021-07-13,42626,10906,IT,East,4,280,31720
2023-07-26,45916,5539,Sales,South,5,229,40377
2021-10-31,21573,28430,IT,East,1,245,-6857
2023-06-25,28939,17076,Sales,West,8,427,11863
2021-01-02,23157,12261,HR,West,7,198,10896
2022-01-13,19322,14220,Operations,North,5,456,5102
2021-09-09,12482,27684,IT,East,6,232,-15202
2022-10-02,45867,5051,Finance,North,1,473,40816
2023-01-26,23675,29818,Operations,North,8,490,-6143
2023-07-15,40420,6686,HR,East,9,299,33734
2022-12-19,21735,24205,Sales,East,5,51,-2470
2021-05-14,23850,27947,Operations,West,7,217,-4097
2023-08-24,16732,29504,Sales,North,4,174,-12772
2022-10-03,48822,13096,Sales,West,6,75,35726
2021-02-14,44422,15032,Operations,South,2,99,29390
2022-10-14,42731,13616,IT,South,4,1,29115
2023-03-09,21428,15319,IT,North,5,124,6109
2023-09-13,21311,13545,Operations,North,9,117,7766
2021-04-08,13733,8690,IT,East,9,343,5043
2021-12-02,49579,23073,Marketing,East,8,195,26506
2020-06-11,18342,13484,Sales,North,4,233,4858
2020-02-29,20464,5716,Operations,North,6,129,14748
2022-11-20,20300,28667,Finance,South,7,374,-8367
2020-11-28,44563,9575,HR,West,1,63,34988
2020-03-16,23708,25956,Operations,South,1,236,-2248
2020-11-12,38090,15670,Operations,South,4,332,22420
2023-12-11,26328,20637,Sales,West,3,230,5691
2020-07-08,36654,21346,HR,North,4,190,15308
2023-08-31,16214,5637,Sales,North,9,189,10577
2020-10-22,48913,12979,Finance,South,2,168,35934
2021-05-15,37552,14491,IT,South,4,95,23061
2020-06-25,45377,25332,Operations,West,7,157,20045
2022-03-10,35734,17631,Sales,East,2,291,18103
2022-03-16,34721,26934,Finance,East,8,348,7787
2022-05-09,28610,13903,Finance,North,4,341,14707
2020-08-02,23622,16725,Marketing,East,9,395,6897
2021-10-14,38875,17070,Operations,North,1,474,21805
2021-08-19,33226,8341,Finance,North,7,139,24885
2023-09-17,37677,21068,IT,North,1,191,16609
2020-05-07,20298,10550,Sales,West,9,453,9748
2023-07-16,45848,25622,Sales,South,1,56,20226
2021-07-04,43755,23167,Marketing,East,3,7,20588
2023-10-21,27744,19688,IT,West,7,51,8056
2021-09-10,33434,22872,Finance,East,1,479,10562
2020-12-13,11726,28544,Marketing,West,5,39,-16818
2020-05-21,24268,21851,Finance,East,6,298,2417
2023-03-14,10907,10583,Finance,East,3,72,324
2022-03-02,35759,17113,Operations,South,6,256,18646
2020-09-01,23764,22801,HR,East,4,309,963
2021-12-03,34409,27289,Finance,West,6,91,7120
2023-08-06,18390,23160,Sales,East,6,149,-4770
2023-02-09,40172,6081,Finance,South,4,30,34091
2020-08-01,45223,18437,Marketing,East,1,462,26786
2020-07-18,47976,24309,Finance,West,3,123,23667
2021-02-08,13365,9084,Sales,East,7,385,4281
2021-02-24,35836,17253,Sales,South,2,237,18583
2020-01-07,38554,12628,Marketing,South,4,280,25926
2021-08-14,31663,11195,Sales,South,6,125,20468
2020-10-12,15951,6011,IT,South,5,134,9940
2021-11-01,25175,29286,IT,North,6,6,-4111
2021-01-23,21027,5813,HR,South,5,383,15214
2021-02-19,20094,17138,IT,East,9,373,2956
2022-02-22,33081,5272,Marketing,East,2,197,27809
2022-10-03,22167,20682,Finance,East,4,190,1485
2023-03-19,18769,25028,IT,East,1,291,-6259
2022-10-11,33060,21192,HR,North,7,384,11868
2021-03-03,11020,23100,Operations,North,1,236,-12080
2022-10-01,21845,11276,Operations,North,6,79,10569
2023-08-09,46612,27616,Marketing,East,9,35,18996
2020-11-29,46341,11828,HR,West,2,304,34513
2020-09-28,20485,5356,IT,West,1,370,15129
2022-12-02,48210,18654,HR,East,3,361,29556
2020-11-14,17914,5203,Sales,South,6,72,12711
2021-06-10,18802,25129,HR,South,7,43,-6327
2022-01-29,43314,22980,IT,East,8,291,20334
2023-04-10,29565,11614,Marketing,South,4,133,17951
2020-11-16,37617,19799,Sales,South,8,287,17818
2022-01-08,35609,5496,HR,West,7,106,30113
2022-12-03,30371,17989,Operations,East,8,159,12382
2021-03-29,29124,21446,IT,North,5,357,7678
2022-01-15,22717,6579,Marketing,West,7,8,16138
2022-07-17,47669,25677,Finance,East,4,262,21992
2022-04-27,36272,9876,IT,East,1,343,26396
2022-05-17,21842,12850,HR,West,3,437,8992
2022-02-12,48476,9125,Marketing,South,9,80,39351
2020-03-23,12082,24097,Operations,South,4,44,-12015
2021-06-26,36261,10328,Sales,West,5,177,25933
2020-11-17,30970,21200,HR,East,3,392,9770
2022-02-24,19795,14272,Marketing,North,6,64,5523
2023-06-11,43028,29271,Sales,East,4,388,13757
2021-06-23,30180,16696,Marketing,North,5,288,13484
2020-09-08,37351,8379,Finance,North,7,309,28972
2022-04-15,48750,22982,HR,East,7,113,25768
2021-03-24,43268,21119,Marketing,East,9,451,22149
2023-06-16,11015,29017,Operations,East,2,319,-18002
2021-05-04,34489,21012,Marketing,North,4,370,13477
2021-04-08,46731,24562,HR,South,8,208,22169
2020-11-09,21866,29428,Marketing,North,4,444,-7562
2023-04-13,45474,26497,Sales,North,3,226,18977
2023-04-18,25272,8372,Sales,North,6,333,16900
2021-01-19,42161,28147,Finance,West,3,417,14014
2020-10-21,12099,22453,IT,South,2,278,-10354
2023-05-23,16386,19412,Finance,North,9,383,-3026
2022-09-12,15338,24160,IT,North,3,287,-8822
2022-01-31,18300,6192,Operations,West,1,280,12108
2022-02-07,31400,22197,Sales,North,9,3,9203
2023-01-03,34641,6152,IT,South,5,33,28489
2020-12-09,14297,27216,Marketing,North,7,478,-12919
2020-05-21,29332,6883,Operations,South,2,410,22449
2021-12-18,25201,21651,HR,South,1,482,3550
2023-05-07,43808,25055,IT,East,6,307,18753
2023-04-09,22810,7812,Finance,West,5,214,14998
2021-02-09,17988,17872,IT,West,6,30,116
2020-08-15,29579,11562,Finance,West,2,419,18017
2021-02-14,31483,12013,Finance,East,7,25,19470
2022-08-09,10503,10177,Sales,East,1,28,326
2022-06-16,15344,25469,Operations,South,8,97,-10125
2021-11-21,18947,21767,Finance,West,7,87,-2820
2022-05-27,19533,24234,Sales,East,7,26,-4701
2022-02-25,25193,28105,Sales,East,6,120,-2912
2020-03-02,11381,28467,Finance,East,5,201,-17086
2023-09-12,17012,22433,Operations,South,9,392,-5421
2022-05-28,25213,23217,Marketing,North,3,357,1996
2023-03-02,37563,13989,IT,East,9,353,23574
2023-04-27,25212,9467,Sales,East,5,15,15745
2020-12-21,40124,24359,IT,East,8,305,15765
2020-03-11,20711,10155,Operations,West,3,254,10556
2020-09-19,40266,29082,Marketing,West,7,111,11184
2020-11-01,19515,29384,HR,East,4,8,-9869
2021-07-11,30193,19136,Marketing,South,5,439,11057
2023-06-01,12131,22674,Operations,North,4,341,-10543
2023-09-13,12424,12961,Marketing,West,9,128,-537
2022-01-31,31823,28983,HR,North,7,186,2840
2021-08-10,19200,12186,Sales,East,6,387,7014
2020-03-14,33031,12506,Marketing,West,6,393,20525
2020-05-21,13216,23571,Finance,North,7,14,-10355
2020-04-11,10016,13258,Finance,East,5,230,-3242
2022-12-24,47438,18302,Operations,West,3,91,29136
2020-07-11,36378,21183,Marketing,East,3,404,15195
2022-08-10,45391,12791,HR,West,7,4,32600
2022-12-21,41734,11770,Operations,North,1,152,29964
2023-06-18,23350,14893,Marketing,North,4,219,8457
2021-02-13,24450,29318,Operations,West,8,76,-4868
2020-10-26,11473,22989,Finance,South,4,284,-11516
2023-05-03,35525,12987,HR,East,1,355,22538
2021-03-29,38572,12165,Sales,North,5,216,26407
2021-07-27,47079,18514,HR,South,1,159,28565
2021-09-10,40110,27438,Sales,West,9,251,12672
2021-09-28,45504,9505,IT,North,8,67,35999
2020-10-27,36888,28631,Finance,North,7,222,8257
2022-02-17,11946,10807,Finance,East,5,192,1139
2022-09-15,31943,11256,Finance,South,4,219,20687
2020-07-20,25740,20156,HR,East,7,373,5584
2021-11-04,36445,16908,Sales,West,3,17,19537
2020-10-28,19176,29435,IT,North,8,390,-10259
2020-12-02,39866,9284,IT,South,5,495,30582
2020-02-01,47269,19438,IT,East,5,107,27831
2023-01-26,21618,7154,Operations,South,1,466,14464
2022-02-11,34736,12742,HR,West,8,444,21994
2023-04-29,48682,19227,HR,North,7,227,29455
2022-12-07,34601,19265,Finance,South,1,475,15336
2023-06-27,42850,24188,HR,West,4,81,18662
2023-06-03,15804,23604,HR,West,4,267,-7800
2023-07-19,29525,14190,Operations,North,9,166,15335
2021-10-26,37419,22105,HR,East,2,357,15314
2020-11-23,33746,28358,Sales,North,4,234,5388
2022-03-07,22812,27187,IT,North,3,162,-4375
2023-04-18,36686,24778,Operations,South,5,175,11908
2022-03-24,45852,9025,Operations,South,7,160,36827
2021-10-26,12045,29512,Finance,East,5,363,-17467
2022-01-15,35336,20907,HR,West,5,376,14429
2022-11-12,40460,19469,IT,South,4,185,20991
2022-07-18,31668,10156,Sales,East,9,174,21512
2022-08-20,44320,19428,IT,North,6,238,24892
2023-10-25,42575,19410,Marketing,West,6,163,23165
2023-06-22,43592,15995,IT,North,6,476,27597
2023-03-29,46516,9812,Sales,West,6,406,36704
2021-01-07,15578,13650,Sales,South,1,400,1928
2020-10-11,47965,21058,Sales,North,6,238,26907
2021-06-04,31079,7456,Operations,North,4,106,23623
2021-11-27,10937,21590,Operations,West,2,118,-10653
2022-03-17,17595,22740,Marketing,East,6,232,-5145
2021-10-08,10424,17960,IT,West,1,76,-7536
2020-05-15,13051,16788,HR,South,1,5,-3737
2020-04-05,45673,28845,Finance,East,5,218,16828
2023-02-16,41342,12156,Marketing,North,6,282,29186
2023-10-29,22238,19265,HR,North,2,333,2973
2020-09-30,37786,13151,HR,North,8,408,24635
2022-05-27,39668,15987,Marketing,South,4,236,23681
2022-04-29,12694,17560,IT,North,4,323,-4866
2023-04-15,13595,27906,Finance,North,5,32,-14311
2022-02-22,11267,7673,HR,East,4,407,3594
2023-07-24,10421,19999,Operations,South,5,177,-9578
2023-03-07,29650,22433,Operations,North,3,485,7217
2020-05-11,17017,11823,Marketing,East,8,119,5194
2022-12-03,19849,23975,Finance,North,6,190,-4126
2023-02-20,33513,11876,Finance,East,8,102,21637
2023-03-05,12226,25388,HR,North,5,365,-13162
2023-10-22,14388,10973,Marketing,South,7,486,3415
2021-01-07,12422,13282,Finance,West,7,461,-860
2023-02-23,49994,13667,Finance,South,6,79,36327
2022-03-18,19269,13056,Operations,East,4,322,6213
2022-01-13,22177,7046,Marketing,North,6,139,15131
2020-02-20,22032,26691,HR,South,9,336,-4659
2023-03-06,17316,12736,HR,North,4,402,4580
2023-03-27,12843,8690,Operations,South,6,226,4153
2020-02-25,38015,24650,Sales,East,6,266,13365
2022-01-13,14111,26013,Sales,West,3,333,-11902
2021-03-03,32043,7745,Finance,South,4,224,24298
2021-03-18,40101,28407,IT,North,3,60,11694
2020-11-21,46992,29660,Operations,North,3,264,17332
2021-10-01,37870,7639,IT,North,4,455,30231
2022-04-08,47747,26320,Finance,East,4,48,21427
2020-03-20,45169,5076,Operations,East,6,81,40093
2021-04-18,39415,11473,HR,West,4,297,27942
2021-01-11,25685,15622,Operations,North,6,475,10063
2022-07-07,25963,24888,Marketing,West,2,379,1075
2020-11-28,39698,23808,IT,North,4,8,15890
2023-04-13,39150,27868,Operations,South,2,349,11282
2021-03-16,31426,10296,IT,South,8,249,21130
2020-05-05,16035,27951,Finance,South,9,244,-11916
2020-08-06,17071,27470,Operations,North,7,165,-10399
2022-08-05,30578,23605,Sales,South,6,347,6973
2020-10-04,38044,5405,IT,North,8,421,32639
2021-08-17,38842,23513,HR,West,4,320,15329
2022-07-23,26531,17308,HR,East,2,187,9223
2020-05-20,12170,28218,Operations,South,4,249,-16048
2022-04-25,34687,20345,HR,North,5,127,14342
2022-10-04,47886,5397,HR,North,9,88,42489
2022-05-26,17297,19665,IT,West,5,45,-2368
2020-04-19,14163,19560,Operations,West,9,400,-5397
2022-12-11,45707,24857,IT,East,9,282,20850
2021-09-04,48495,15000,Operations,West,8,246,33495
2021-12-13,34448,9989,HR,East,5,415,24459
2023-09-04,13616,25310,Operations,East,2,411,-11694
2023-05-07,48173,23328,Finance,West,5,218,24845
2022-03-06,41748,13629,Operations,East,1,427,28119
2021-12-29,38299,10391,Marketing,South,8,15,27908
2022-12-05,21557,26783,Operations,East,2,256,-5226
2021-05-19,48648,5222,Marketing,North,7,314,43426
2022-11-06,24096,22994,IT,North,2,177,1102
2020-11-10,43781,12830,Marketing,North,5,335,30951
2023-12-30,18743,21230,IT,West,7,215,-2487
2023-11-12,17391,25988,Operations,North,6,25,-8597
2020-03-17,19355,9000,IT,West,5,492,10355
2022-09-04,15247,24048,HR,North,6,324,-8801
2022-06-17,16290,22449,Finance,East,2,292,-6159
2023-10-26,44076,18487,Operations,West,1,117,25589
2023-04-03,35817,26748,Marketing,North,1,80,9069
2022-11-13,47595,10393,Finance,East,8,175,37202
2021-12-12,42827,28486,Sales,West,3,232,14341
2022-11-24,36209,28885,Finance,East,3,315,7324
2022-05-03,49754,5603,Operations,East,9,469,44151
2023-03-07,42118,26514,Finance,East,6,436,15604
2021-12-09,25216,11295,Finance,West,4,40,13921
2020-09-21,17860,13380,HR,West,4,171,4480
2020-11-28,23425,12103,IT,South,7,117,11322
2020-07-06,23806,22021,Finance,South,6,184,1785
2022-12-22,34911,19546,Marketing,South,2,81,15365
2022-03-30,35406,20456,Marketing,South,9,387,14950
2023-07-26,44360,23228,HR,West,2,71,21132
2023-04-09,24464,19674,Finance,South,8,140,4790
2020-10-25,40587,5046,Finance,North,4,193,35541
2020-07-19,48865,5819,HR,South,1,171,43046
2023-03-04,16458,8807,Operations,North,1,101,7651
2020-09-28,19151,24406,Sales,North,9,70,-5255
2021-06-18,46934,6080,Sales,East,4,174,40854
2023-01-15,16488,8146,IT,East,1,444,8342
2020-01-31,34541,22661,Marketing,East,3,189,11880
2023-02-18,31803,16926,Operations,South,3,433,14877
2020-03-09,34718,20930,Marketing,West,7,215,13788
2022-06-01,21170,20172,Operations,North,6,25,998
2022-08-18,27430,20287,HR,West,8,89,7143
2022-04-06,19260,11741,IT,West,7,131,7519
2022-07-12,17636,7217,HR,South,1,196,10419
2023-03-15,46955,26649,Marketing,West,3,319,20306
2022-09-10,46108,7886,IT,West,9,286,38222
2023-09-18,48945,18344,Finance,East,4,225,30601
2021-04-25,25941,27018,Operations,East,3,349,-1077
2023-07-10,13435,13987,Operations,North,5,388,-552
2020-10-19,38355,24712,IT,North,8,334,13643
2023-12-23,17300,12293,HR,East,1,341,5007
2020-03-26,32183,8006,IT,South,2,327,24177
2022-11-05,43733,11958,HR,South,7,149,31775
2021-12-28,17444,29356,IT,North,1,71,-11912
2021-09-19,35755,15581,HR,East,5,129,20174
2020-04-27,33062,9143,Sales,South,8,444,23919
2020-09-26,24610,19699,IT,West,6,290,4911
2023-11-19,10500,26901,HR,North,3,87,-16401
2022-09-05,14554,22602,Finance,North,7,387,-8048
2022-05-04,35545,13018,Marketing,West,3,18,22527
2020-06-10,16771,14952,Marketing,West,5,43,1819
2021-11-30,27499,13916,IT,North,7,76,13583
2023-02-01,13932,22728,IT,West,2,334,-8796
2020-06-15,36055,5137,Operations,South,4,41,30918
2020-10-26,47202,25834,HR,North,2,476,21368
2020-01-28,37700,19156,IT,South,7,362,18544
2023-12-18,13567,18381,Marketing,North,3,365,-4814
2021-07-15,11658,26290,Marketing,South,9,280,-14632
2022-06-01,36627,18893,Marketing,East,6,280,17734
2020-06-04,48568,21360,HR,South,1,259,27208
2023-09-09,30760,24143,Sales,West,8,443,6617
2023-10-03,39985,5058,IT,East,7,442,34927
2023-02-18,24408,22154,Sales,North,1,329,2254
2021-10-13,39832,5388,HR,South,3,24,34444
2022-03-31,45583,17116,Finance,North,3,450,28467
2021-07-14,43738,24806,IT,East,3,375,18932
2023-04-02,34204,12012,Operations,West,7,296,22192
2022-12-21,23285,17626,IT,West,6,476,5659
2023-09-25,42975,9852,IT,West,2,327,33123
2020-11-07,26643,21979,IT,North,5,393,4664
2021-01-10,15025,13627,IT,West,6,109,1398
2023-10-01,47126,6982,Finance,West,2,359,40144
2020-05-29,26888,19816,IT,North,1,444,7072
2021-08-07,44527,16060,HR,North,4,423,28467
2021-08-03,33898,17401,IT,East,4,289,16497
2022-09-03,24387,15411,Finance,West,4,418,8976
2020-06-25,13794,13209,HR,East,1,318,585
2020-12-19,13590,25714,IT,South,3,341,-12124
2021-05-28,24698,10429,IT,South,7,317,14269
2020-11-04,22332,17158,HR,South,4,349,5174
2020-04-28,49738,23076,IT,South,2,27,26662
2022-02-05,19593,24154,Finance,North,8,126,-4561
2022-09-22,40107,9376,Marketing,East,1,401,30731
2022-08-30,41490,26310,IT,East,9,316,15180
2022-07-04,46097,24651,Operations,North,5,170,21446
2021-04-22,21036,28948,HR,South,2,47,-7912
2023-12-08,38561,23079,Finance,East,4,368,15482
2021-08-09,24372,18978,IT,West,3,343,5394
2020-12-16,44860,22970,IT,North,7,181,21890
2020-07-13,29351,17705,HR,North,6,365,11646
2023-04-25,40327,26064,Sales,West,9,405,14263
2021-05-10,28059,26831,Finance,South,4,392,1228
2021-05-29,37188,26844,Finance,South,3,73,10344
2021-11-26,43055,15861,Marketing,East,7,122,27194
2020-09-29,12316,12965,Marketing,West,6,353,-649
2022-05-29,26259,23652,IT,East,5,186,2607
2020-02-21,45606,15248,HR,South,7,324,30358
2020-09-19,21829,19220,Operations,East,5,319,2609
2023-10-23,18137,28633,IT,West,9,443,-10496
2020-05-12,34502,12461,Marketing,West,4,82,22041
2022-09-20,37204,17821,IT,West,1,480,19383
2023-06-02,11265,24870,HR,South,5,30,-13605
2020-11-05,45751,18410,Finance,North,1,281,27341
2020-01-16,32285,27185,Finance,North,1,121,5100
2020-07-13,34315,24133,Finance,North,1,353,10182
2020-10-29,43379,29169,Finance,East,1,355,14210
2022-12-07,46291,28359,Operations,West,8,106,17932
2023-02-18,37152,6405,Sales,South,2,312,30747
2022-04-11,15424,16179,Operations,North,9,418,-755
2021-07-15,19939,8575,IT,North,7,434,11364
2020-02-10,40253,7727,Marketing,East,3,130,32526
2021-06-17,44396,11487,HR,East,9,205,32909
2021-01-05,23176,19760,IT,North,4,53,3416
2023-04-20,17907,11291,Sales,West,7,382,6616
2021-05-31,13372,7501,HR,West,3,297,5871
2021-10-18,37572,22321,HR,East,5,279,15251
2021-08-12,34592,15272,HR,East,4,189,19320
2020-08-18,23102,6755,IT,West,6,215,16347
2022-03-19,35642,8390,Sales,East,9,31,27252
2023-10-03,13139,10816,IT,East,5,450,2323
2021-04-23,21643,22600,HR,West,1,258,-957
2023-05-17,28643,22587,HR,West,5,453,6056
2021-11-05,45018,6890,Marketing,South,5,60,38128
2020-10-04,48889,16223,Operations,East,9,78,32666
2020-02-22,38780,18829,IT,East,8,23,19951
2022-10-30,26667,29966,Sales,South,5,185,-3299
2022-01-17,40632,12688,HR,East,5,35,27944
2021-04-08,48493,11500,IT,East,2,494,36993
2022-01-23,39408,11716,Operations,North,9,1,27692
2021-08-05,34302,8746,IT,North,4,105,25556
2020-06-06,31621,29674,Operations,North,7,176,1947
2020-01-19,23219,23579,IT,South,6,49,-360
2020-02-24,35939,26049,Marketing,East,5,168,9890
2021-12-21,46843,18014,IT,South,5,318,28829
2022-11-10,22778,20675,Finance,South,7,271,2103
2023-07-29,48930,14193,Marketing,East,2,158,34737
2022-01-30,39870,28733,Operations,West,9,21,11137
2022-10-15,32121,25782,HR,West,2,392,6339
2023-12-11,40158,8629,HR,East,9,391,31529
2022-03-18,33456,12766,IT,West,4,105,20690
2021-12-23,22992,11147,Sales,North,6,290,11845
2020-10-11,35390,20113,IT,East,1,121,15277
2021-05-25,26756,19442,Marketing,South,5,192,7314
2022-10-18,31971,19410,Marketing,North,6,426,12561
2023-11-20,17071,6063,Operations,South,9,229,11008
2020-04-29,37574,13830,IT,West,9,496,23744
2020-04-06,29275,15934,Operations,East,9,181,13341
2020-04-29,16586,14334,Sales,North,3,352,2252
2023-03-22,29703,15312,HR,East,4,225,14391
2023-06-22,36765,8275,HR,North,8,454,28490
2021-01-27,20641,5976,IT,North,8,234,14665
2023-03-12,46735,17383,Operations,North,2,266,29352
2022-03-04,10822,16406,Operations,East,8,346,-5584
2020-08-07,42989,16739,Sales,North,7,314,26250
2022-04-18,49648,9069,Operations,North,9,499,40579
2020-06-08,22129,20604,Finance,East,5,365,1525
2023-01-04,25543,19612,Finance,South,2,218,5931
2021-09-02,35963,21334,Marketing,West,5,211,14629
2021-09-30,46656,11402,Finance,East,2,99,35254
2022-11-21,39665,17333,Finance,East,5,109,22332
2022-02-15,23499,5345,Marketing,North,9,388,18154
2020-11-29,20352,9942,Finance,East,7,345,10410
2022-06-10,29654,24326,Finance,East,7,253,5328
2022-07-28,20117,28788,Marketing,West,1,392,-8671
2020-12-17,31077,22460,IT,East,9,12,8617
2023-09-24,13993,14363,Marketing,North,6,118,-370
2022-07-14,28982,8770,Marketing,West,7,88,20212
2023-11-24,44434,27036,Finance,East,2,344,17398
2021-01-30,26312,16353,HR,North,1,209,9959
2023-05-10,24338,13424,Finance,West,4,409,10914
2021-06-13,40173,16990,IT,East,9,481,23183
2023-01-21,47525,13048,Marketing,North,9,411,34477
2020-12-23,36690,17099,Sales,West,3,130,19591
2023-11-20,37328,16891,Marketing,North,1,329,20437
2022-04-07,21360,20573,IT,West,2,183,787
2020-02-29,48883,21834,Operations,East,9,442,27049
2021-04-21,48205,14554,Finance,South,9,417,33651
2021-09-03,32625,5350,HR,West,1,83,27275
2020-01-01,41850,14500,HR,East,9,254,27350
2020-11-06,26471,9004,Finance,West,1,433,17467
2020-06-16,49883,16117,Finance,South,4,5,33766
2020-07-10,37276,26062,IT,North,5,303,11214
2022-11-23,12703,21628,Marketing,South,8,468,-8925
2022-11-23,21151,26029,Sales,South,5,24,-4878
2023-12-11,36998,18015,Marketing,North,5,121,18983
2021-12-08,14147,9734,Marketing,South,4,95,4413
2023-03-27,44515,17871,Sales,East,9,428,26644
2020-12-31,18232,20162,HR,West,8,452,-1930
2023-09-25,25151,21824,Marketing,South,9,224,3327
2022-05-07,20330,16737,Operations,West,7,239,3593
2023-09-20,21276,14659,Operations,West,7,227,6617
2020-11-22,28535,27299,IT,North,5,142,1236
2020-04-23,46705,21795,IT,South,1,420,24910
2022-03-07,49654,5813,Sales,North,6,51,43841
2022-07-07,42976,26062,Sales,North,6,390,16914
2023-12-12,10599,23114,IT,West,4,145,-12515
2023-03-12,13709,11643,Finance,East,2,338,2066
2021-08-31,34110,18269,Marketing,West,1,328,15841
2020-11-04,15723,23358,Finance,North,3,307,-7635
2021-02-04,37394,5549,HR,South,9,52,31845
2023-09-05,20316,19452,Operations,East,1,12,864
2020-07-30,32622,23321,Sales,East,5,337,9301
2020-11-12,34844,5203,IT,South,6,95,29641
2020-07-03,31162,20718,Operations,South,9,371,10444
2023-05-13,38833,8588,Finance,East,1,129,30245
2023-10-19,27206,28467,Sales,North,5,11,-1261
2023-05-24,34501,7536,Sales,East,1,490,26965
2020-09-02,20291,27172,Marketing,East,2,272,-6881
2020-08-26,21659,13298,Sales,East,2,357,8361
2023-11-15,35226,25195,HR,North,5,369,10031
2021-06-03,16500,7701,Sales,South,4,92,8799
2020-10-03,11634,17089,HR,South,6,9,-5455
2022-10-02,24059,15411,Finance,South,5,375,8648
2020-07-20,14814,12825,Marketing,North,2,123,1989
2020-08-01,14076,10974,HR,North,9,264,3102
2021-08-28,48210,25320,Finance,South,8,281,22890
2021-04-22,35931,9090,Operations,West,9,458,26841
2021-05-22,42007,28340,Sales,West,6,424,13667
2023-01-03,32744,15559,IT,South,5,451,17185
2021-10-30,40396,14252,IT,West,5,119,26144
2021-10-26,33083,7546,HR,West,2,407,25537
2020-05-21,46273,8736,Marketing,South,4,190,37537
2020-11-17,35276,19600,HR,South,2,279,15676
2021-04-05,10502,6672,Finance,North,2,300,3830
2021-12-07,22756,5401,Finance,West,8,56,17355
2021-10-31,24262,20322,HR,West,4,196,3940
2023-03-15,20605,16191,HR,South,4,379,4414
2020-02-23,32416,9313,Operations,East,7,498,23103
2023-10-11,47487,19665,Finance,South,4,23,27822
2020-10-03,37543,16644,Operations,North,9,265,20899
2021-02-03,41280,27736,HR,East,9,245,13544
2021-10-29,12870,16826,Marketing,East,3,260,-3956
2021-05-30,14758,29863,Sales,East,6,418,-15105
2023-08-27,48736,21471,Finance,North,7,231,27265
2023-07-18,21659,28530,IT,West,3,210,-6871
2021-07-29,19585,21303,Operations,South,4,162,-1718
2020-04-21,37903,11279,Finance,North,1,377,26624
2020-08-26,47039,23589,Sales,North,9,354,23450
2023-03-13,14323,7967,Operations,East,7,170,6356
2023-10-29,36970,9250,Finance,East,7,387,27720
2022-11-09,44806,24918,Operations,North,9,339,19888
2023-08-05,15461,29795,Operations,West,6,290,-14334
2020-07-15,44030,8238,HR,East,8,474,35792
2021-01-16,15731,13513,HR,North,5,227,2218
2020-06-12,31500,7738,Operations,East,8,361,23762
2021-08-28,19903,9936,Operations,South,1,363,9967
2023-06-26,43117,6836,IT,South,3,479,36281
2022-12-27,38602,23943,Sales,South,4,43,14659
2022-05-04,41174,6568,Sales,East,9,475,34606
2022-11-10,43208,15514,Marketing,East,8,195,27694
2022-04-10,29192,19047,Marketing,West,8,421,10145
2021-08-19,23899,9720,Marketing,South,2,12,14179
2023-11-14,28946,12957,HR,West,7,495,15989
2021-06-19,13152,16155,HR,North,3,471,-3003
2020-04-20,35960,13544,IT,North,6,465,22416
2022-08-06,20247,11525,HR,South,4,272,8722
2022-05-12,40806,21083,Marketing,West,6,62,19723
2021-08-17,35573,12935,Finance,East,4,17,22638
2022-10-18,36038,29605,Operations,West,3,271,6433
2021-04-04,37770,28898,Marketing,North,2,26,8872
2023-01-06,16949,28449,IT,West,4,45,-11500
2021-03-09,12205,11737,Operations,North,2,386,468
2023-11-04,27855,7540,HR,North,7,145,20315
2022-06-06,29564,25203,Operations,West,1,65,4361
2022-02-21,23133,29407,Finance,East,1,350,-6274
2023-09-24,28114,22218,IT,North,5,480,5896
2022-09-14,42803,24708,HR,West,7,286,18095
2023-12-18,39785,22013,Sales,North,1,490,17772
2020-06-17,48302,7986,Marketing,South,4,68,40316
2021-12-09,33545,29605,Finance,East,5,362,3940
2022-08-22,20952,19958,Finance,South,2,300,994
2023-07-09,12535,29463,Marketing,North,7,96,-16928
2021-12-27,34721,29317,IT,East,4,60,5404
2020-08-16,14963,25166,IT,West,8,483,-10203
2023-03-30,22707,11485,Finance,West,1,257,11222
2021-03-02,22860,26790,Marketing,East,1,19,-3930
2020-05-01,24247,24852,Operations,South,1,33,-605
2020-05-28,27410,28528,Sales,South,4,467,-1118
2022-05-01,27670,16772,Sales,East,1,420,10898
2021-12-05,29230,15152,IT,West,5,91,14078
2020-04-20,34158,17531,IT,East,6,461,16627
2023-05-29,23887,29796,Operations,South,7,475,-5909
2020-03-04,45061,26659,IT,North,8,238,18402
2021-09-29,33810,10867,Sales,West,8,462,22943
2023-10-09,35358,27900,Marketing,East,2,24,7458
2022-06-27,25933,9626,Finance,North,4,227,16307
2020-01-13,40034,7262,Sales,South,7,339,32772
2022-07-22,11947,7414,Operations,West,9,381,4533
2023-03-22,29715,15353,Marketing,East,9,409,14362
2020-08-26,40956,20559,Marketing,South,3,395,20397
2023-04-28,31644,17312,Finance,East,7,265,14332
2021-10-24,25310,10240,Sales,East,4,6,15070
2023-01-14,32450,19053,Marketing,West,9,58,13397
2022-11-10,26303,14049,Marketing,South,7,100,12254
2021-11-24,34031,10122,IT,South,6,122,23909
2023-09-04,39250,9993,Marketing,North,9,357,29257
2023-03-27,31853,23876,Operations,South,7,157,7977
2022-08-28,27977,20613,Marketing,South,8,201,7364
2022-08-21,24465,13211,IT,West,5,225,11254
2020-03-16,20225,18515,HR,North,4,471,1710
2020-11-24,26640,13997,HR,West,1,463,12643
2023-12-10,41535,21335,Operations,South,8,267,20200
2023-05-11,49280,7175,Finance,North,6,151,42105
2023-06-06,12991,7405,Finance,West,4,410,5586
2020-05-31,27801,24747,Operations,North,3,257,3054
2020-03-12,34144,12341,Marketing,South,5,478,21803
2020-08-12,17965,29284,Marketing,North,4,81,-11319
2021-04-17,23730,16156,HR,North,7,431,7574
2020-12-25,39553,20963,HR,North,6,366,18590
2021-06-23,18301,22989,Sales,South,3,425,-4688
2022-03-21,28936,23941,HR,South,1,407,4995
2021-08-31,24155,20779,HR,North,7,100,3376
2022-12-05,31117,23426,Operations,West,5,105,7691
2020-01-01,12042,5778,Sales,West,1,252,6264
2021-11-08,28565,8159,Finance,South,1,133,20406
2023-06-22,47260,11395,Sales,East,6,99,35865
2023-05-27,46326,6746,Marketing,West,4,178,39580
2020-10-17,13658,10974,Marketing,North,8,265,2684
2020-07-22,26319,10150,Sales,East,2,132,16169
2023-05-10,29078,17132,Sales,South,4,199,11946
2021-07-19,46652,21804,Marketing,West,8,193,24848
2021-04-26,47548,15043,Operations,East,8,208,32505
2021-05-25,29668,23492,Operations,South,5,57,6176
2022-07-12,48720,9674,Operations,South,3,380,39046
2020-10-04,32546,26729,Operations,North,4,409,5817
2022-10-01,47874,8996,Marketing,West,3,442,38878
2020-01-16,47165,27466,IT,East,2,262,19699
2020-12-21,38898,14550,HR,North,4,230,24348
2020-12-21,39907,25294,HR,West,9,142,14613
2022-04-09,39372,7626,HR,East,6,63,31746
2021-08-21,24822,5490,HR,South,4,118,19332
2023-01-06,29776,14487,Marketing,South,1,485,15289
2022-07-16,42406,27316,IT,West,7,459,15090
2022-12-26,20462,15273,Marketing,North,2,321,5189
2022-05-08,46479,24755,IT,East,6,308,21724
2020-08-01,44354,18684,Marketing,East,1,490,25670
2021-03-24,49906,16366,Sales,South,7,321,33540
2022-08-22,17662,25448,IT,West,4,245,-7786
2023-12-27,17404,27221,HR,North,3,381,-9817
2023-02-12,19542,20906,IT,South,7,356,-1364
2022-02-25,25904,9989,Finance,South,3,136,15915
2023-12-14,37774,17021,Operations,North,8,96,20753
2021-05-13,18556,27355,IT,East,4,225,-8799
2021-12-10,22806,8380,Finance,East,3,8,14426
2021-01-14,24864,10689,Operations,West,7,14,14175
2023-03-12,40016,13603,Finance,South,7,24,26413
2022-01-09,43749,12473,Operations,West,9,192,31276
2021-09-23,46320,6676,Sales,East,7,241,39644
2022-11-13,27305,12790,IT,North,6,489,14515
2021-06-22,21938,10282,Finance,East,3,349,11656
2022-08-02,26318,24095,Sales,East,4,25,2223
2023-01-03,30379,18376,HR,South,8,390,12003
2022-01-22,47820,14431,IT,East,6,129,33389
2021-06-18,15406,5602,Marketing,West,9,87,9804
2021-11-03,30661,6937,Marketing,North,8,233,23724
2022-11-30,27858,29505,Marketing,South,8,289,-1647
2021-07-21,40816,29601,Finance,North,7,398,11215
2023-12-07,22850,11812,Finance,West,1,447,11038
2021-02-18,22601,6067,Operations,West,5,56,16534
2021-03-24,49866,18401,Marketing,East,7,190,31465
2021-09-01,36644,10252,HR,West,9,28,26392
2021-10-19,37428,18472,Finance,East,4,29,18956
2021-03-11,49487,27247,IT,South,8,491,22240
2021-12-05,43380,5379,Finance,North,1,488,38001
2020-08-26,17286,26886,IT,East,4,279,-9600
2022-12-01,20068,24566,Finance,East,4,172,-4498
2022-01-03,19805,25131,Operations,South,2,38,-5326
2022-03-10,13017,10196,Operations,West,3,433,2821
2020-01-10,31172,26516,Operations,East,3,299,4656
2022-01-16,19926,27424,HR,West,9,266,-7498
2023-07-12,33486,18881,Finance,East,7,27,14605
2020-05-18,40397,17119,IT,West,2,136,23278
2021-12-31,39511,25504,Finance,East,9,236,14007
2020-07-14,20002,13737,Sales,North,8,245,6265
2023-01-02,13201,10259,Operations,North,6,452,2942
2023-06-02,43520,29850,Marketing,North,6,469,13670
2023-01-30,37048,16633,Sales,East,2,85,20415
2020-09-20,40130,15461,Sales,West,3,414,24669
2022-08-02,11341,7922,Operations,South,6,13,3419
2022-07-08,23981,8387,Marketing,South,3,58,15594
2020-06-09,18696,26826,Operations,South,7,259,-8130
2023-06-10,24525,26936,Operations,North,5,468,-2411
2021-05-05,36545,19553,Marketing,North,4,100,16992
2022-02-08,38625,15062,Sales,North,8,104,23563
2020-11-06,15565,25397,Sales,West,2,261,-9832
2020-08-14,24947,26751,Finance,North,3,278,-1804
2020-09-29,40077,29686,Marketing,West,4,442,10391
2022-07-26,16517,11959,Sales,West,6,66,4558
2020-11-12,24287,14947,HR,West,5,89,9340
2023-01-14,21829,27674,Operations,East,5,296,-5845
2020-10-17,12422,14559,HR,South,7,88,-2137
2021-12-29,39060,5551,HR,West,8,378,33509
2023-11-28,15985,5133,Finance,South,6,5,10852
2023-12-21,49715,11607,Finance,West,3,144,38108
2021-01-09,23790,16103,Finance,West,4,117,7687
2021-07-20,35168,15205,HR,North,1,271,19963
2022-05-17,34019,11599,IT,South,5,499,22420
2022-01-24,13668,18372,IT,West,8,205,-4704
2020-09-08,20744,10124,HR,South,3,75,10620
2020-11-02,38754,6060,Operations,North,4,80,32694
2023-12-24,29522,28768,HR,West,4,18,754
2021-11-05,14509,19048,HR,North,6,217,-4539
2022-05-17,12500,23570,Finance,West,9,431,-11070
2020-09-20,19904,24049,Finance,North,3,102,-4145
2020-03-08,36921,8170,Finance,North,4,488,28751
2023-02-04,26683,15919,IT,East,6,132,10764
2023-11-24,22416,24030,HR,West,6,309,-1614
2023-05-07,24833,21979,Operations,West,7,58,2854
2023-04-30,28290,20583,Operations,West,1,112,7707
2021-05-28,45253,9106,Finance,South,9,85,36147
2022-02-07,24003,27201,Finance,East,2,331,-3198
2021-03-17,16120,8421,HR,South,4,314,7699
2020-01-01,24251,21303,Operations,West,3,116,2948
2020-12-23,32486,7278,HR,East,3,315,25208
2023-02-12,38334,22548,IT,North,5,162,15786
2022-06-21,16172,22001,HR,East,7,286,-5829
2023-05-05,32706,18052,Finance,North,7,438,14654
2020-09-30,28472,5450,Sales,West,7,324,23022
2022-05-05,31695,14990,IT,West,3,206,16705
2022-10-14,49255,17778,Operations,North,9,331,31477
2023-03-29,21055,12372,Operations,East,6,68,8683
2020-06-21,42716,6892,Finance,South,8,410,35824
2021-08-07,16880,26912,Finance,East,1,387,-10032
2023-12-27,38949,23838,IT,North,4,248,15111
2022-07-17,29810,18362,Finance,North,7,57,11448
2021-04-25,10528,8808,Sales,South,9,165,1720
2021-03-30,28308,14476,IT,South,3,166,13832
2020-07-14,32844,23141,Finance,South,6,297,9703
2022-03-06,32360,21606,Marketing,North,8,4,10754
2021-08-21,32405,28337,Sales,West,3,410,4068
2023-08-25,27246,28420,IT,East,6,295,-1174
2021-07-09,37792,23749,Marketing,South,9,365,14043
2022-04-27,30704,6609,HR,North,9,106,24095
2021-03-14,40589,28605,Sales,East,6,108,11984
2021-10-11,32436,6223,HR,South,5,170,26213
2020-12-24,34643,6907,Marketing,West,1,267,27736
2022-11-25,28026,19978,Operations,East,3,267,8048
2022-11-23,25693,15943,Operations,East,3,54,9750
2023-01-16,19212,10810,Finance,North,4,486,8402
2021-10-19,47964,17161,Operations,North,5,166,30803
2020-01-16,23850,27832,HR,North,8,254,-3982
2022-01-14,49767,29350,Sales,West,9,276,20417
2021-02-24,17322,19063,HR,East,7,154,-1741
2021-07-06,45911,9937,HR,South,6,128,35974
2022-02-05,40387,27132,Operations,West,3,486,13255
2022-03-03,15678,22615,HR,South,9,76,-6937
2023-02-23,11382,17260,Marketing,South,1,375,-5878
2022-10-28,31780,14939,IT,North,9,221,16841
2022-05-29,37506,15750,IT,South,3,270,21756
2022-05-01,41848,5737,IT,South,9,434,36111
2021-05-24,49882,25820,Finance,West,1,123,24062
2023-11-26,11705,24363,Operations,North,8,25,-12658
2023-04-14,15997,20935,Operations,South,6,439,-4938
2022-08-23,32447,15143,IT,South,9,435,17304
2022-07-02,24535,21913,Sales,South,4,106,2622
2023-10-22,34480,17321,Finance,East,5,106,17159
2020-01-18,41051,28525,IT,East,6,103,12526
2020-02-25,22129,9418,HR,North,9,474,12711
2022-07-07,40785,14396,IT,West,6,266,26389
2022-11-24,39402,6986,IT,North,9,14,32416
2022-06-20,12704,5346,Sales,East,2,133,7358
2021-09-21,37027,10825,Operations,North,4,441,26202
2022-03-04,15725,6215,Operations,West,3,22,9510
2020-12-12,35223,18890,HR,North,4,75,16333
2022-11-21,36769,15960,IT,South,1,285,20809
2022-06-26,37384,29429,Marketing,West,2,391,7955
2022-10-20,42145,27182,HR,West,4,244,14963
2023-03-02,42892,5244,Operations,West,4,256,37648
2021-07-29,40027,19119,Sales,North,5,146,20908
2020-07-17,22767,28442,Operations,North,9,415,-5675
2023-07-03,31481,16243,Operations,South,1,427,15238
2023-09-27,47575,5132,Sales,West,8,212,42443
2023-06-08,28354,20556,IT,South,3,249,7798
2020-10-27,29146,22754,IT,West,9,35,6392
2022-10-13,31901,6087,Operations,East,8,327,25814
2020-01-26,13101,14839,HR,North,8,253,-1738
2023-11-11,38727,15083,Marketing,South,9,350,23644
2023-08-01,44422,18415,HR,North,4,260,26007
2021-03-25,26515,25386,Finance,North,5,307,1129
2020-11-15,34806,15452,HR,East,7,350,19354
2020-06-04,43162,18828,Operations,East,2,286,24334
2021-04-15,13573,13310,Operations,West,7,350,263
2021-02-23,49874,7903,Marketing,East,3,181,41971
2023-02-10,35508,28206,Marketing,West,6,210,7302
2021-10-12,35985,5894,Marketing,East,6,491,30091
2023-12-16,15060,6265,Operations,East,6,110,8795
2022-06-04,20933,27807,Operations,South,2,330,-6874
2022-07-18,16632,21746,HR,East,9,142,-5114
2022-04-14,49523,28548,Operations,South,8,164,20975
2022-05-25,32973,14965,Finance,East,7,87,18008
2022-07-30,15589,13505,IT,South,9,140,2084
2022-09-20,21612,27016,IT,North,4,332,-5404
2023-08-01,28888,23090,Marketing,West,2,162,5798
2021-07-25,29417,12334,Operations,East,4,26,17083
2020-02-23,22015,28297,Finance,South,3,134,-6282
2021-08-27,45744,18374,IT,East,2,357,27370
2020-11-20,27855,18348,HR,South,2,115,9507
2022-08-27,21891,20375,Sales,South,8,181,1516
2022-06-03,37762,7393,HR,East,5,399,30369
2020-09-21,16595,16802,Sales,West,6,362,-207
2021-01-16,38557,29510,Finance,South,8,359,9047
2023-05-21,31936,8694,HR,North,7,147,23242
2020-11-28,28281,22373,IT,East,7,360,5908
2022-10-30,12192,19911,Operations,North,7,431,-7719
2023-10-13,43859,25064,Sales,South,7,215,18795
2020-07-21,44946,15655,Operations,South,8,484,29291
2020-02-27,42309,14096,Finance,East,1,77,28213
2023-05-31,45455,11410,Operations,West,3,95,34045
2023-10-24,38672,8397,IT,North,1,445,30275
2023-12-12,13756,25381,Finance,West,8,485,-11625
2021-06-30,48829,18031,Marketing,North,2,218,30798
2022-05-20,32918,5910,Marketing,West,7,363,27008
2020-04-12,14494,27970,Sales,East,6,368,-13476
2023-03-30,44047,27365,IT,North,1,52,16682
2023-05-08,16538,23507,Operations,East,6,274,-6969
2023-03-29,12221,23235,HR,West,9,444,-11014
2022-05-14,15164,19915,HR,West,3,175,-4751
2023-03-05,43622,27840,Finance,West,7,313,15782
2021-02-01,45980,17863,Sales,East,4,33,28117
2021-01-26,29152,16957,Sales,South,1,360,12195
2020-04-15,24385,6615,Sales,South,7,416,17770
2022-12-13,33612,15582,IT,North,1,132,18030
2023-07-24,22530,14397,HR,East,4,425,8133
2020-04-20,13340,9026,Finance,East,9,275,4314
2020-08-11,33124,11869,IT,East,5,7,21255
2020-03-15,43043,15871,Finance,West,7,495,27172
2021-05-20,22295,23830,IT,East,7,227,-1535
2022-11-03,30247,8312,Operations,South,3,255,21935
2022-02-08,10714,13014,IT,North,8,282,-2300
2021-04-26,48822,28241,IT,South,1,236,20581
2023-04-27,10809,10019,Operations,East,4,343,790
2020-12-29,40144,15293,Marketing,North,4,354,24851
2020-08-26,30362,8216,Operations,North,2,435,22146
2023-11-25,10036,26859,Sales,East,6,184,-16823
2022-04-25,42402,25053,Marketing,East,1,199,17349
2022-09-11,34498,16222,HR,South,3,203,18276
2023-08-20,38387,23908,Finance,South,9,435,14479
2023-01-19,20273,28882,IT,West,6,136,-8609
2021-01-26,35030,18603,Marketing,West,2,397,16427
2023-04-22,21403,18340,HR,West,9,288,3063
2022-11-06,25037,15934,Operations,East,2,489,9103
2022-08-22,29039,23345,Operations,East,7,290,5694
2020-01-12,24017,27687,Sales,West,1,146,-3670
2023-04-04,27365,9625,Sales,West,5,207,17740
2020-05-25,49215,13292,Marketing,South,7,55,35923
2023-07-29,22583,14505,Finance,West,3,299,8078
2020-06-17,42919,8448,IT,West,4,408,34471
2022-04-26,19514,24628,Operations,North,5,495,-5114
2020-06-18,48416,19678,Marketing,West,3,405,28738
2022-02-03,11511,11047,Marketing,North,6,402,464
2023-10-01,28642,26058,Finance,West,3,398,2584
2021-05-13,26615,6214,Marketing,North,8,250,20401
2023-08-13,41589,28990,Sales,West,7,437,12599
2023-03-11,34225,25010,Finance,South,1,275,9215
2022-06-15,30846,14558,Operations,East,2,205,16288
2022-12-12,39152,12875,Sales,North,4,313,26277
2020-04-27,10571,27652,Sales,East,5,192,-17081
2020-12-30,36188,18919,Finance,South,4,336,17269
2020-05-15,23217,20225,Finance,West,4,2,2992
2023-12-08,16609,28196,Marketing,West,9,185,-11587
2023-01-05,15151,16815,HR,South,4,162,-1664
2021-07-10,16406,10479,HR,East,4,49,5927
2020-01-18,24893,5172,HR,East,4,90,19721
2021-02-06,42956,22270,Marketing,East,2,438,20686
2020-07-23,17145,21044,IT,East,8,251,-3899
2021-05-13,48695,11263,Operations,North,4,22,37432
2020-11-19,43367,25752,Marketing,East,5,212,17615
2021-08-17,23133,16621,Marketing,North,8,477,6512
2021-07-15,22209,14601,Sales,South,4,466,7608
2023-07-28,36965,12056,HR,West,5,477,24909
2023-04-04,19145,26337,Finance,North,5,234,-7192
2023-06-20,44638,19245,Marketing,East,6,172,25393
2021-04-23,30645,20678,IT,West,7,91,9967
2020-06-12,28408,5260,Operations,North,3,163,23148
2020-11-19,22521,24736,IT,West,3,285,-2215
2021-07-04,31878,6352,Marketing,South,9,6,25526
2022-04-10,48221,10243,Marketing,East,1,244,37978
2021-10-01,44595,14691,Sales,South,8,421,29904
2021-09-25,31086,17565,IT,West,3,379,13521
2022-01-28,26923,24390,Sales,South,5,473,2533
2020-07-26,26225,22206,Finance,East,3,341,4019
2020-11-10,17202,21915,IT,North,1,442,-4713
2020-10-30,40139,24204,HR,South,5,448,15935
2022-06-19,41974,5166,Finance,East,8,159,36808
2020-08-26,36941,26310,HR,West,5,123,10631
2022-03-14,47206,17523,IT,South,4,360,29683
2023-06-01,29885,22439,Sales,North,9,434,7446
2023-01-16,21218,6254,HR,South,1,464,14964
2023-12-23,38750,9286,Marketing,West,5,188,29464
2023-05-28,41612,13009,Operations,West,1,14,28603
2020-10-01,16716,9007,Sales,West,6,70,7709
2022-08-11,26088,19992,Finance,South,9,139,6096
2022-12-25,41001,12758,Finance,South,2,411,28243
2023-12-17,49586,14723,IT,South,4,358,34863
2020-09-11,32584,19590,Finance,North,8,325,12994
2020-05-04,14286,20638,Operations,East,3,79,-6352
2023-03-15,14739,17234,Operations,South,7,294,-2495
2021-09-06,40158,19011,Marketing,North,7,318,21147
2021-01-19,44857,12889,Finance,West,2,437,31968
2021-03-22,15605,17016,Sales,South,4,80,-1411
2021-01-21,49590,20415,Operations,South,1,146,29175
2021-01-17,13321,9744,Sales,South,8,373,3577
2023-07-24,43984,29681,Marketing,North,9,225,14303
2023-11-06,47653,14796,IT,South,1,227,32857
2020-05-03,22170,16965,Operations,South,7,382,5205
2023-07-14,18933,9287,Operations,East,1,180,9646
2023-02-08,32692,6002,Operations,North,1,24,26690
2023-11-05,41474,18589,Finance,East,9,99,22885
2023-03-27,19906,17922,Sales,East,6,391,1984
2021-12-28,33814,5084,Operations,East,1,270,28730
2022-06-14,45565,24379,Sales,East,7,434,21186
2023-02-15,10818,18015,Finance,West,3,94,-7197
2020-11-23,18434,20373,HR,South,4,280,-1939
2021-11-24,40571,10156,HR,East,4,463,30415
2022-12-27,38890,12194,Sales,North,8,269,26696
2023-12-28,22069,10783,Finance,South,1,147,11286
2020-12-24,42780,10695,HR,East,8,285,32085
2022-09-29,48662,17357,Marketing,East,9,22,31305
2022-03-07,33434,21537,Marketing,North,7,2,11897
2021-03-18,17392,14653,HR,West,1,103,2739
2020-06-12,26102,27798,IT,North,7,461,-1696
2022-08-30,43457,28068,Sales,West,6,36,15389
2020-12-26,32262,7019,HR,West,5,294,25243
2021-08-07,21932,21155,Sales,West,5,274,777
2023-02-16,21766,5570,Finance,East,1,51,16196
2022-05-02,32711,12922,HR,East,6,143,19789
2022-10-07,23292,21200,Marketing,West,4,384,2092
2023-05-03,30687,29724,Finance,West,1,483,963
2022-10-20,35899,16769,IT,East,8,436,19130
2020-08-28,17408,11153,Sales,West,8,17,6255
2021-10-27,20694,24075,IT,East,4,368,-3381
2021-07-18,44533,29053,Marketing,West,7,77,15480
2023-03-11,25237,15301,Operations,East,3,278,9936
2022-04-11,15778,10507,Operations,North,8,123,5271
2022-09-02,45059,9869,Sales,West,7,438,35190
2020-01-31,36561,27233,Finance,West,5,436,9328
2020-08-10,14866,20591,Marketing,North,5,488,-5725
2020-09-22,18429,27351,Sales,South,9,384,-8922
2023-07-29,32837,8655,Finance,West,6,469,24182
2022-02-26,44075,21347,Sales,South,6,346,22728
2021-01-15,44853,28055,Sales,North,2,174,16798
2021-07-09,36395,27053,IT,West,5,132,9342
2020-03-02,26415,7492,HR,South,4,263,18923
2021-12-13,41986,17304,Marketing,West,3,394,24682
2022-04-26,34104,11512,IT,West,9,271,22592
2021-06-04,10291,20243,Finance,East,7,410,-9952
2022-12-30,13686,13774,HR,South,4,208,-88
2021-08-24,11642,9350,Sales,East,9,296,2292
2020-05-19,41477,27983,Operations,East,9,226,13494
2023-09-01,34150,15882,IT,South,7,189,18268
2023-09-25,18769,9656,Marketing,South,5,465,9113
2021-08-12,39833,13511,Marketing,East,9,358,26322
2021-06-11,13909,25699,HR,West,7,144,-11790
2021-06-24,42078,26178,IT,West,9,354,15900
2023-12-10,22268,22821,Sales,North,3,251,-553
2021-01-09,20844,21415,HR,West,9,376,-571
2020-10-17,18638,5714,Finance,South,1,477,12924
2020-02-12,47141,29339,Marketing,South,5,245,17802
2022-12-12,21233,20089,Finance,North,2,18,1144
2023-06-09,40496,14231,IT,South,1,203,26265
2023-05-20,27806,21792,Operations,East,3,204,6014
2020-01-08,23271,20163,Finance,North,7,485,3108
2021-04-27,49513,21008,Sales,North,3,2,28505
2020-02-11,29465,12346,Marketing,West,9,438,17119
2020-11-28,49502,13038,IT,West,3,376,36464
2023-06-10,23860,29124,Operations,East,6,402,-5264
2022-12-29,18250,29048,Marketing,East,2,54,-10798
2022-11-05,31310,26415,Operations,West,8,166,4895
2020-03-09,37982,22511,Marketing,West,5,353,15471
2020-02-22,42206,26820,HR,East,2,329,15386
2021-11-15,19764,13898,HR,West,7,143,5866
2022-09-20,22842,17031,HR,North,3,448,5811
2023-11-03,47491,16215,IT,East,5,92,31276
2021-06-10,34043,16851,HR,West,9,8,17192
2020-03-03,47971,5782,IT,South,1,252,42189
2020-09-17,12976,10300,Sales,South,2,430,2676
2023-02-18,17426,23563,HR,East,5,100,-6137
2022-05-07,32887,28190,IT,South,4,39,4697
2023-06-17,36710,6178,Marketing,South,1,436,30532
2023-02-04,16486,7406,IT,North,7,136,9080
2020-06-28,49258,18546,Finance,East,9,362,30712
2022-11-05,32623,24191,IT,South,1,434,8432
2020-12-20,33806,17452,Finance,West,8,50,16354
2022-07-22,15973,24148,Marketing,East,9,83,-8175
2023-08-25,39157,7724,IT,East,2,254,31433
2021-12-27,15521,7535,Marketing,South,1,196,7986
2021-08-11,22891,29788,Finance,South,6,27,-6897
2021-08-27,26795,15140,Operations,North,7,77,11655
2020-06-29,32474,26245,HR,West,2,294,6229
2020-06-22,36507,27684,Finance,North,5,255,8823
2020-12-19,20687,29240,Sales,North,5,21,-8553
2020-12-19,43014,24530,IT,West,7,218,18484
2023-05-27,21009,27962,Marketing,South,1,45,-6953
2023-08-31,33226,6201,HR,North,8,442,27025
2021-03-09,32948,15011,IT,East,5,407,17937
2022-06-23,44939,7889,HR,North,3,182,37050
2020-10-08,32102,22028,Operations,West,9,286,10074
2020-09-15,44828,15551,IT,North,3,479,29277
2022-05-17,46102,27335,Marketing,North,7,351,18767
2021-07-12,43712,25606,Operations,East,7,144,18106
2020-01-05,36823,17664,IT,West,8,52,19159
2021-08-18,15361,20704,HR,East,8,251,-5343
2021-01-28,35838,9320,Operations,South,4,106,26518
2020-12-01,24638,8088,Marketing,West,1,297,16550
2020-03-03,48052,13688,IT,North,4,199,34364
2020-02-13,33265,15208,HR,East,6,337,18057
2020-06-01,34751,13664,HR,East,6,280,21087
2022-05-03,20916,15080,Finance,West,6,148,5836
2023-03-25,19509,24766,Operations,East,7,103,-5257
2020-10-01,41102,12925,IT,West,1,411,28177
2023-10-13,34324,6160,Finance,South,1,2,28164
2021-03-01,24003,15714,HR,West,7,256,8289
2021-04-27,37943,9312,Operations,West,4,60,28631
2020-08-01,43101,13387,Sales,South,6,307,29714
2020-03-19,39943,23632,HR,South,6,385,16311
2020-05-18,19456,25845,Operations,North,9,482,-6389
2022-08-07,21369,24150,Sales,East,2,91,-2781
2020-04-07,29329,22935,Operations,South,4,101,6394
2021-10-25,23218,7447,HR,South,4,114,15771
2020-07-16,31164,27028,Sales,East,7,262,4136
2022-02-23,47424,9309,Operations,East,1,422,38115
2020-06-04,22410,15580,IT,North,5,54,6830
2022-12-09,39730,28880,Sales,North,4,188,10850
2021-04-23,12665,13310,Operations,West,2,27,-645
2020-08-15,49899,8496,IT,North,5,240,41403
2021-06-05,47703,6716,Sales,South,9,80,40987
2020-05-28,10415,26321,Operations,South,8,190,-15906
2022-12-17,43475,24298,HR,East,9,319,19177
2020-06-10,34172,20732,Sales,North,7,355,13440
2022-05-12,12684,6672,Sales,West,7,91,6012
2023-02-04,17494,14394,IT,West,2,35,3100
2023-12-21,29750,6455,Finance,West,3,58,23295
2021-01-29,29887,19031,Finance,West,8,189,10856
2022-03-11,30826,18232,Operations,East,2,253,12594
2020-07-04,16180,27929,HR,North,7,36,-11749
2021-07-11,12559,21340,IT,North,6,358,-8781
2021-03-21,13971,12026,Sales,North,4,92,1945
2022-04-09,45725,20438,Finance,North,4,56,25287
2020-03-27,28113,8978,IT,West,3,67,19135
2023-06-26,22951,7471,IT,West,6,313,15480
2023-07-04,35617,13309,IT,East,3,169,22308
2023-07-24,42794,5367,Sales,East,9,287,37427
2021-03-13,12583,18417,Marketing,West,4,131,-5834
2021-05-30,35628,24560,IT,South,4,166,11068
2022-08-04,36250,8374,Marketing,North,2,437,27876
2023-05-10,13055,11773,Finance,East,2,52,1282
2022-01-25,16801,19205,HR,West,7,152,-2404
2022-03-07,44426,8812,Finance,North,5,410,35614
2023-04-18,46719,27675,HR,North,3,105,19044
2021-11-16,33840,27369,HR,West,6,367,6471
2020-11-20,19933,23581,Finance,South,6,92,-3648
2021-09-14,41979,26295,Operations,South,1,201,15684
2021-11-17,14137,19351,Sales,East,3,293,-5214
2021-02-03,21423,5900,Marketing,West,5,373,15523
2022-05-17,34315,21576,Operations,East,7,219,12739
2020-08-04,44482,7770,Marketing,South,4,432,36712
2022-03-19,46115,16540,Sales,East,8,67,29575
2022-08-18,44754,10180,IT,East,3,169,34574
2022-09-27,46312,20308,Finance,South,6,305,26004
2023-11-28,33363,22334,Operations,North,6,28,11029
2022-07-20,27085,11679,Sales,North,9,288,15406
2020-08-27,46554,8606,Finance,South,4,355,37948
2023-04-24,24415,19678,Operations,North,7,455,4737
2020-02-17,31398,26422,HR,West,1,327,4976
2023-11-10,42691,5257,Operations,North,1,469,37434
2023-05-16,16659,22605,IT,South,2,32,-5946
2023-03-26,30644,19388,IT,West,4,166,11256
2023-06-02,13044,22034,Marketing,East,6,404,-8990
2023-03-13,13883,15510,Operations,South,4,136,-1627
2023-12-13,41712,7425,HR,South,6,68,34287
2023-02-08,29324,20011,IT,North,2,154,9313
2022-05-24,31545,24543,Marketing,West,9,463,7002
2020-05-11,28204,5397,HR,South,3,326,22807
2021-09-16,33268,26685,HR,West,7,304,6583
2021-08-23,25762,16106,HR,West,1,96,9656
2021-11-03,38371,26786,Sales,North,8,197,11585
2020-11-29,28847,29084,IT,South,4,108,-237
2023-01-03,46139,21944,Sales,West,5,46,24195
2023-12-06,20116,13381,Sales,West,7,186,6735
2020-02-05,40125,13396,IT,East,3,454,26729
2022-02-16,41404,16207,Operations,North,9,323,25197
2020-08-10,38436,26483,Finance,South,9,285,11953
2021-06-13,12788,8371,Marketing,West,8,83,4417
2020-08-28,42149,8041,Finance,North,1,138,34108
2020-05-13,14125,11844,Finance,South,2,327,2281
2021-01-25,13606,14897,Finance,West,2,237,-1291
2020-04-11,42988,26782,Finance,South,3,449,16206
2021-11-11,31306,22096,IT,South,2,321,9210
2021-05-12,20833,8456,Finance,North,1,145,12377
2021-05-25,31997,15876,Marketing,North,5,278,16121
2021-12-03,43521,28331,Operations,East,6,100,15190
2022-09-20,39948,9406,IT,East,7,14,30542
2022-08-06,17488,18165,Finance,East,7,262,-677
2023-09-28,49974,16791,HR,West,2,414,33183
2022-04-20,17938,18144,IT,East,7,494,-206
2020-01-06,48726,12649,Operations,South,2,47,36077
2022-08-15,25770,8877,Finance,North,2,225,16893
2020-07-12,16635,24906,Sales,South,6,404,-8271
2022-01-11,18629,10651,IT,North,6,144,7978
2023-03-06,41668,17818,HR,North,8,196,23850
2022-06-30,31487,9112,IT,South,5,290,22375
2021-04-17,22869,9565,Sales,South,5,257,13304
2020-08-03,19219,26290,IT,West,1,461,-7071
2023-10-04,26673,26807,HR,North,4,432,-134
2022-05-25,26763,9977,Operations,East,1,8,16786
2023-04-21,21043,24062,HR,West,5,278,-3019
2023-04-06,19570,13775,Operations,East,8,324,5795
2020-02-07,16886,26325,HR,West,1,290,-9439
2021-04-15,11958,28713,Marketing,North,3,444,-16755
2021-03-27,34641,15188,IT,South,1,429,19453
2023-03-11,12183,5841,IT,South,6,293,6342
2022-10-09,39070,15567,Sales,North,1,377,23503
2020-04-12,13774,9038,Marketing,South,3,23,4736
2020-02-11,39018,6804,Sales,North,5,84,32214
2022-08-04,30303,13921,IT,North,5,255,16382
2023-03-16,24272,9349,Sales,North,2,373,14923
2020-03-06,32586,14655,Operations,West,3,24,17931
2022-07-31,43545,19906,Marketing,South,9,475,23639
2020-07-11,12566,19879,HR,West,1,397,-7313
2023-08-14,20953,9946,Operations,East,1,325,11007
2022-11-27,41696,15359,Finance,North,2,336,26337
2021-05-16,17404,28502,HR,South,8,316,-11098
2023-12-22,42846,11657,Sales,East,6,38,31189
2021-10-25,11581,20989,IT,North,4,432,-9408
2020-12-17,24066,22956,Operations,East,7,221,1110
2020-11-21,17839,18266,Marketing,West,6,410,-427
2022-11-27,44930,11240,HR,West,9,214,33690
2023-01-25,32129,26350,Finance,South,6,472,5779
2020-04-17,40845,14585,Operations,East,2,333,26260
2021-09-22,23913,20776,IT,East,3,491,3137
2020-05-30,10964,21640,Marketing,West,9,85,-10676
2023-01-02,20739,5127,Marketing,West,7,385,15612
2022-12-16,12673,14574,HR,South,6,4,-1901
2022-05-27,48061,16920,Operations,North,5,195,31141
2020-11-30,41171,19392,Operations,South,3,114,21779
2023-06-29,33643,19917,Marketing,West,4,215,13726
2022-03-14,44486,28251,Sales,South,1,336,16235
2022-02-05,20624,29238,Marketing,North,5,365,-8614
2023-07-01,11228,7205,IT,West,7,141,4023
2023-11-09,44608,13513,Operations,North,2,167,31095
2020-09-15,26920,15548,HR,South,8,287,11372
2022-02-20,29689,9379,Operations,North,6,408,20310
2020-02-03,17124,13067,Marketing,West,3,495,4057
2020-11-21,41339,16305,IT,West,2,384,25034
2022-04-16,17587,17148,Sales,North,8,335,439
2023-06-15,13527,27661,Operations,South,4,5,-14134
2021-11-21,43067,17901,Marketing,South,7,127,25166
2022-01-08,13963,15888,Finance,South,7,433,-1925
2022-01-13,47455,14708,Marketing,South,9,86,32747
2023-08-20,46939,16485,Marketing,East,8,86,30454
2022-04-26,30243,25708,IT,East,8,395,4535
2020-04-26,42693,19117,Marketing,North,7,24,23576
2023-05-15,13695,19220,Marketing,East,5,45,-5525
2021-10-11,19112,29694,Marketing,East,9,458,-10582
2021-02-06,42059,21221,Operations,East,7,111,20838
2022-09-23,17242,12081,Marketing,North,3,290,5161
2020-08-20,19941,7371,IT,East,6,395,12570
2022-07-17,30001,10016,Finance,South,3,185,19985
2023-07-31,12700,11302,Operations,South,6,235,1398
2021-04-24,28085,11382,Finance,North,8,157,16703
2022-09-02,23339,27923,Marketing,North,9,406,-4584
2020-01-09,25834,17607,Sales,North,2,161,8227
2021-12-15,21084,16452,Finance,West,6,200,4632
2021-01-13,39543,27836,IT,East,3,122,11707
2021-01-15,45930,27776,Sales,North,7,433,18154
2022-04-23,41902,26180,IT,North,4,224,15722
2020-12-25,39044,20865,Sales,North,5,488,18179
2020-06-24,23137,23825,Marketing,South,6,365,-688
2021-04-29,44905,6017,Sales,North,8,23,38888
2023-11-29,15948,25885,Finance,South,2,197,-9937
2020-02-02,42567,8047,Sales,South,4,479,34520
2021-11-26,41189,18492,IT,West,4,285,22697
2020-06-05,41871,15260,Marketing,North,6,6,26611
2021-07-18,28189,27178,IT,West,4,308,1011
2020-07-20,32797,18894,Marketing,North,5,345,13903
2023-04-13,13569,16857,Finance,East,5,89,-3288
2023-06-21,36012,9250,HR,North,8,479,26762
2023-07-16,22977,27331,Operations,North,4,378,-4354
2022-07-11,42049,29769,Finance,North,6,398,12280
2020-03-14,31694,12391,Finance,North,7,273,19303
2020-04-05,43224,7446,Operations,North,8,464,35778
2020-06-21,26832,28507,IT,North,9,284,-1675
2023-11-30,42835,22783,Finance,West,8,265,20052
2020-06-03,11862,15711,Marketing,East,4,115,-3849
2023-04-21,28186,27679,Sales,West,4,124,507
2023-09-08,39545,17119,Finance,East,5,450,22426
2020-10-15,18319,8687,Operations,West,3,260,9632
2020-09-14,48663,21367,Finance,West,2,404,27296
2020-06-22,38401,12864,IT,North,2,169,25537
2020-11-25,42228,11127,IT,West,9,36,31101
2023-06-08,22202,21936,IT,East,8,229,266
2022-01-28,48283,26927,Marketing,South,6,134,21356
2022-10-16,30122,18834,Finance,East,9,244,11288
2020-06-09,43135,13921,IT,West,5,65,29214
2020-07-04,32585,23944,HR,South,1,237,8641
2020-05-22,24897,10108,Sales,North,8,434,14789
2023-07-29,31291,9266,IT,South,3,448,22025
2022-06-25,42826,9945,Marketing,North,9,3,32881
2021-10-01,18294,13985,Sales,East,1,37,4309
2020-01-27,14507,27068,Sales,South,3,109,-12561
2023-06-23,38854,29700,Operations,South,1,490,9154
2020-07-20,25475,13366,IT,South,1,250,12109
2022-11-10,24334,7551,IT,North,6,3,16783
2021-10-31,28830,8848,Finance,North,4,235,19982
2023-01-22,37278,8456,Marketing,East,4,417,28822
2022-10-28,28749,24142,HR,East,5,443,4607
2021-04-16,40511,17031,Finance,West,3,251,23480
2023-09-24,47469,25139,HR,North,2,143,22330
2020-09-15,35072,25026,Operations,East,8,248,10046
2020-02-24,41146,13119,HR,South,7,56,28027
2022-06-29,21057,15162,Marketing,South,4,61,5895
2022-10-26,36427,6660,Operations,South,2,68,29767
2023-11-01,21036,29613,IT,East,9,79,-8577
2021-07-07,24060,18208,HR,South,8,327,5852
2022-12-09,23607,15716,Marketing,South,4,367,7891
2020-04-21,45102,26970,Marketing,North,5,196,18132
2020-05-25,34074,18009,IT,North,6,446,16065
2020-08-17,29773,24960,Marketing,East,4,195,4813
2021-05-11,42970,27842,Operations,North,2,23,15128
2023-08-22,42998,16727,Operations,West,5,14,26271
2021-04-05,38210,27509,Finance,East,1,390,10701
2022-03-17,21683,18921,Sales,West,7,289,2762
2020-08-13,12962,18021,IT,West,9,9,-5059
2020-02-28,45095,24307,Marketing,East,3,140,20788
2023-01-04,40000,16233,HR,North,6,242,23767
2021-03-03,39137,24092,Finance,North,9,253,15045
2021-12-28,45552,17600,Operations,East,4,227,27952
2023-03-01,43571,25555,IT,West,6,373,18016
2022-07-20,49164,15501,IT,East,3,95,33663
2021-05-12,26559,13422,Operations,East,9,179,13137
2022-03-26,15691,24134,Sales,South,7,3,-8443
2022-06-28,13532,20739,IT,South,7,184,-7207
2023-08-21,30733,15885,Marketing,West,4,46,14848
2020-03-07,27927,12476,HR,North,6,292,15451
2020-08-17,23482,12931,HR,South,8,141,10551
2022-09-09,36681,18699,Operations,South,6,13,17982
2020-11-28,15456,7804,IT,West,6,186,7652
2020-10-03,13413,21136,HR,East,4,482,-7723
2021-12-21,17085,26828,IT,South,8,85,-9743
2020-05-23,37937,22225,Operations,North,8,418,15712
2023-06-28,30563,10575,Sales,West,9,490,19988
2021-11-21,19332,16775,HR,South,6,43,2557
2023-01-08,47575,28894,Marketing,West,2,384,18681
2020-02-26,17386,15681,Finance,South,4,156,1705
2023-10-21,36337,19918,Operations,South,4,184,16419
2020-11-03,44708,27789,Finance,West,8,47,16919
2020-06-22,39572,18106,Sales,North,5,419,21466
2022-01-19,43424,24918,Marketing,North,4,206,18506
2022-09-30,45271,29241,Finance,East,8,210,16030
2021-11-08,21030,5607,Marketing,South,3,275,15423
2021-07-13,23138,28778,HR,East,2,83,-5640
2023-10-29,25646,9618,IT,West,4,97,16028
2020-12-14,38812,19089,Operations,East,1,179,19723
2022-12-26,33422,20568,Marketing,West,1,355,12854
2020-11-25,20645,25344,HR,North,5,148,-4699
2020-07-12,24628,9257,Sales,West,1,285,15371
2023-03-24,34486,20931,Marketing,West,4,384,13555
2023-03-29,32409,26996,Sales,East,8,72,5413
2020-09-22,49266,20794,Operations,South,8,217,28472
2020-06-16,32732,15223,HR,East,2,209,17509
2020-05-24,29425,21585,Sales,North,3,321,7840
2020-07-04,22195,27943,IT,North,3,294,-5748
2022-06-04,28722,26515,Finance,North,1,433,2207
2022-05-14,26494,6364,Sales,South,3,124,20130
2022-02-12,31571,5751,Sales,East,8,350,25820
2023-12-17,44486,18237,HR,West,6,156,26249
2022-10-03,32900,19708,HR,West,5,33,13192
2022-02-24,10125,12545,Marketing,South,9,269,-2420
2021-04-01,29318,10344,Finance,North,7,216,18974
2020-12-10,48685,6205,Sales,South,6,428,42480
2022-01-04,17590,14512,Sales,West,5,101,3078
2021-07-07,44850,8887,HR,North,5,470,35963
2022-10-17,22134,6330,IT,South,9,180,15804
2022-02-26,35230,13622,HR,West,6,127,21608
2022-07-24,25058,28903,IT,West,4,333,-3845
2021-12-05,24301,9683,Finance,South,4,488,14618
2023-02-01,47861,23658,HR,West,4,460,24203
2020-09-03,37039,28907,Finance,East,6,377,8132
2022-03-22,10284,8365,Operations,East,1,169,1919
2022-11-12,48334,22647,Sales,North,9,305,25687
2022-08-10,28658,25620,Finance,East,2,366,3038
2022-03-25,38443,9299,IT,East,2,135,29144
2020-05-23,13972,8733,Operations,South,5,292,5239
2021-12-30,36167,6665,IT,North,4,93,29502
2022-05-12,23679,5860,Marketing,South,3,221,17819
2023-05-01,39519,22228,Marketing,South,5,410,17291
2021-04-09,35704,16681,Sales,East,7,155,19023
2021-01-09,46881,21520,Operations,East,2,280,25361
2021-11-07,41948,27131,Operations,West,6,479,14817
2021-11-22,24378,27878,Marketing,West,4,199,-3500
2021-09-20,20328,16424,Sales,North,2,337,3904
2023-07-13,34732,10786,Finance,East,1,241,23946
2023-11-02,27673,14345,Marketing,West,8,417,13328
2021-07-09,20373,27584,Operations,South,5,98,-7211
2022-05-12,15720,16598,IT,East,2,250,-878
2020-03-14,15153,13325,Operations,North,8,402,1828
2021-03-13,16226,23445,Sales,North,3,105,-7219
2022-05-30,12976,9378,Operations,South,7,261,3598
2020-08-13,48019,16045,HR,West,2,129,31974
2020-11-03,46267,8730,Operations,South,7,327,37537
2022-08-23,29297,16684,HR,West,4,378,12613
2020-12-13,26587,29702,Marketing,East,1,482,-3115
2021-04-20,28206,11122,Finance,North,5,259,17084
2023-08-31,35935,6795,HR,West,4,292,29140
2021-06-08,39633,15041,Operations,South,8,419,24592
2023-12-19,20736,25697,Finance,East,1,435,-4961
2021-06-07,16971,13187,Finance,West,2,377,3784
2021-07-15,19507,9840,Operations,East,5,140,9667
2023-06-26,35724,15919,Operations,East,2,15,19805
2021-07-22,32166,8726,Sales,South,1,388,23440
2023-04-20,23158,5259,Marketing,South,6,184,17899
2020-04-15,35774,22625,HR,East,4,481,13149
2020-07-09,21108,6843,IT,East,5,16,14265
2023-03-06,22077,27161,HR,West,3,221,-5084
2021-11-30,14175,18754,Operations,South,6,390,-4579
2023-02-17,45627,7280,IT,West,4,63,38347
2022-04-10,12962,12796,IT,North,6,241,166
2020-03-12,23616,9567,HR,West,5,485,14049
2022-01-24,42253,14300,HR,East,2,279,27953
2023-02-28,27751,29956,HR,North,4,333,-2205
2021-04-01,15210,6255,HR,West,2,428,8955
2022-06-23,42390,11462,Marketing,North,5,257,30928
2021-04-23,45677,15432,Sales,South,3,185,30245
2020-02-21,46173,23042,Sales,West,6,76,23131
2022-09-30,25993,24032,HR,West,5,27,1961
2021-07-27,36859,19942,Sales,South,2,25,16917
2023-02-16,30878,17150,HR,West,8,342,13728
2023-07-11,24923,8371,HR,North,6,62,16552
2023-06-16,43588,24813,HR,South,9,482,18775
2023-10-06,37100,26244,Finance,North,3,146,10856
2022-06-11,34086,12620,Marketing,West,4,233,21466
2020-09-11,42571,7932,Operations,West,8,464,34639
2021-11-15,21017,26470,Sales,West,7,349,-5453
2023-08-25,47221,14778,Sales,West,8,286,32443
2020-02-26,29513,28033,Marketing,North,9,414,1480
2022-08-07,24860,15304,Marketing,West,8,84,9556
2023-11-27,18086,13119,HR,South,8,175,4967
2022-12-26,28050,19557,HR,South,6,406,8493
2022-12-05,29784,19407,Finance,East,2,381,10377
2021-08-28,21774,9983,Finance,South,7,170,11791
2021-01-03,44968,7521,Operations,East,4,290,37447
2020-08-19,22142,24086,Sales,South,3,447,-1944
2023-11-26,33007,21402,Marketing,South,4,4,11605
2022-06-26,35158,23953,Operations,West,4,498,11205
2022-11-12,16051,21343,Sales,South,3,287,-5292
2021-07-27,41576,5783,Operations,West,9,307,35793
2023-07-14,14115,14898,Operations,West,3,50,-783
2022-04-20,29024,21798,HR,South,2,270,7226
2020-04-27,16371,13555,Operations,North,1,8,2816
2022-12-14,38690,15767,HR,West,1,357,22923
2023-03-22,49355,6103,Sales,South,5,69,43252
2023-06-16,42420,26275,Finance,North,5,392,16145
2023-07-12,19080,10309,Sales,South,9,139,8771
2020-09-24,11883,6171,HR,South,4,248,5712
2020-04-22,14821,13634,Finance,North,5,29,1187
2020-06-14,46590,11408,IT,South,6,183,35182
2021-10-29,18338,17135,Finance,West,7,213,1203
2022-10-28,32007,26129,Operations,East,9,423,5878
2021-12-14,12477,25945,Sales,East,6,397,-13468
2023-05-25,23135,29556,Operations,South,1,320,-6421
2021-03-06,20437,18710,Finance,East,8,305,1727
2023-08-08,19502,11636,IT,East,2,19,7866
2022-06-11,39236,7589,Operations,East,9,383,31647
2022-12-09,10368,15031,IT,West,7,451,-4663
2020-04-16,35839,14695,Marketing,West,7,226,21144
2022-10-29,45515,20527,IT,East,5,230,24988
2022-01-14,17562,10722,Sales,North,8,339,6840
2021-11-30,17139,18402,Finance,North,1,96,-1263
2020-11-18,37141,22106,HR,North,3,495,15035
2020-11-04,16704,5841,HR,West,9,484,10863
2022-04-29,11887,23731,Operations,West,1,115,-11844
2021-09-13,21975,5645,Finance,West,8,359,16330
2022-09-21,10544,13215,Marketing,West,6,180,-2671
2020-05-24,29448,24656,Operations,East,5,373,4792
2022-01-09,32830,21390,IT,West,6,78,11440
2022-03-31,33926,8701,HR,East,5,327,25225
2021-02-15,41002,18908,IT,North,9,276,22094
2020-04-23,23333,14463,HR,East,2,352,8870
2021-07-28,26942,17453,HR,North,6,366,9489
2021-02-02,24684,17715,HR,West,4,182,6969
2023-07-22,36088,10630,Finance,North,3,95,25458
2020-05-03,32447,20902,Sales,North,5,86,11545
2020-03-26,18861,7556,Finance,East,2,389,11305
2020-02-16,34833,24338,IT,North,3,95,10495
2022-08-01,27454,12387,Finance,South,7,335,15067
2023-05-09,11050,28172,Operations,North,1,492,-17122
2023-07-23,30422,14858,Marketing,West,2,446,15564
2023-02-27,31530,18630,Operations,North,3,145,12900
2022-03-14,25756,9661,Finance,South,7,248,16095
2021-01-23,14022,8801,IT,East,4,181,5221
2021-07-29,12634,27017,Marketing,North,8,293,-14383
2023-07-10,37145,12413,Operations,South,8,19,24732
2021-09-23,17288,22547,Marketing,West,1,138,-5259
2023-07-25,18992,17071,IT,West,5,44,1921
2021-12-14,44253,22665,HR,East,1,226,21588
2022-12-05,37005,15856,IT,West,7,433,21149
2023-04-06,22166,16087,Sales,South,4,345,6079
2021-09-13,38065,13187,Marketing,North,8,37,24878
2020-02-15,27798,21686,IT,South,8,314,6112
2021-12-24,39301,18805,HR,East,9,220,20496
2021-06-23,13894,13947,HR,North,6,128,-53
2020-03-27,13846,25643,IT,South,7,143,-11797
2022-03-13,24481,27147,Operations,East,7,404,-2666
2023-11-09,40221,14418,IT,East,5,183,25803
2020-09-21,18048,29564,HR,North,7,397,-11516
2022-11-11,37386,12575,IT,North,9,404,24811
2021-12-03,43336,14425,Sales,West,4,43,28911
2020-08-19,49258,10978,Operations,West,2,479,38280
2020-07-04,33853,19436,IT,North,8,210,14417
2020-11-21,44713,14089,HR,West,7,425,30624
2023-04-21,26791,27474,IT,North,6,48,-683
2021-01-31,14228,13154,IT,West,7,312,1074
2023-11-27,21945,13183,Marketing,South,3,220,8762
2023-12-11,49899,27064,IT,East,6,367,22835
2023-05-10,34681,27895,Sales,North,7,196,6786
2022-12-24,44986,8362,HR,North,7,472,36624
2022-08-13,24975,16101,Finance,North,5,172,8874
2021-07-08,17711,14646,Marketing,South,3,237,3065
2022-01-02,22105,23396,Finance,East,2,457,-1291
2022-11-06,40146,22484,IT,West,7,175,17662
2022-03-07,25238,20755,Operations,West,4,434,4483
2023-04-21,13868,10104,Sales,East,2,32,3764
2021-01-25,20060,26999,Sales,West,8,224,-6939
2020-02-13,15433,14512,Sales,North,2,54,921
2022-06-19,32612,21069,Marketing,East,6,423,11543
2021-04-26,27822,21306,IT,South,4,469,6516
2023-07-10,44120,21255,Sales,East,9,186,22865
2023-04-12,31294,9502,IT,North,5,492,21792
2021-07-19,28764,20252,Operations,East,4,234,8512
2020-08-07,14560,29007,IT,South,8,317,-14447
2023-11-18,26583,25971,Finance,South,3,231,612
2022-02-10,25560,11037,IT,East,9,110,14523
2023-05-03,14424,22539,IT,East,8,475,-8115
2021-02-12,36863,14292,HR,West,8,367,22571
2021-04-15,39469,19466,Finance,West,5,100,20003
2023-10-02,47565,5996,Marketing,North,1,200,41569
2022-12-20,33184,14627,IT,West,9,211,18557
2020-06-14,33910,26593,Sales,North,2,221,7317
2021-11-02,32404,23929,HR,North,1,403,8475
2023-03-20,45175,25084,IT,East,6,325,20091
2020-04-20,13791,28149,HR,West,1,150,-14358
2021-07-02,42208,9984,Marketing,South,7,163,32224
2022-10-23,49276,21737,HR,South,7,394,27539
2022-11-02,19629,7318,Sales,East,1,143,12311
2023-03-31,42894,18703,IT,South,5,258,24191
2020-12-09,31990,17719,Sales,South,3,245,14271
2020-11-27,17694,7519,Operations,East,2,490,10175
2020-09-20,46087,10427,HR,South,5,150,35660
2020-03-23,18673,9603,HR,East,5,112,9070
2022-02-15,48199,29630,HR,North,2,99,18569
2022-07-12,42187,23468,Finance,West,6,103,18719
2020-11-29,14378,5899,Marketing,South,7,211,8479
2023-11-04,33553,21846,Finance,East,1,495,11707
2023-05-27,49258,22885,Sales,South,3,12,26373
2021-10-19,32524,17068,Operations,West,4,381,15456
2021-03-29,26622,22099,Marketing,South,2,226,4523
2021-11-03,11420,10330,Marketing,North,5,446,1090
2022-01-10,10340,28558,IT,East,4,301,-18218
2023-01-17,14987,24995,Operations,West,2,442,-10008
2020-11-28,36062,14180,HR,North,1,148,21882
2020-11-05,42456,21595,Finance,South,8,179,20861
2021-12-27,48180,28740,HR,South,2,7,19440
2023-12-14,35308,22137,IT,South,4,152,13171
2020-12-19,29862,20473,Finance,West,5,323,9389
2022-04-03,17670,8750,HR,East,2,70,8920
2023-01-28,34246,16881,Sales,West,9,353,17365
2020-05-24,23766,24606,HR,North,2,53,-840
2022-10-30,39681,21819,Finance,East,6,162,17862
2022-12-03,18323,9929,Sales,West,7,417,8394
2023-11-10,11857,19796,IT,South,6,93,-7939
2022-06-28,40587,23344,IT,North,4,151,17243
2022-01-30,35818,25656,Sales,South,1,58,10162
2021-05-09,35247,10813,Finance,West,2,196,24434
2023-04-07,43272,6724,Finance,North,6,325,36548
2021-10-03,28540,29761,HR,East,8,482,-1221
2021-06-14,35837,6494,IT,East,3,208,29343
2023-09-21,18484,23363,IT,West,7,424,-4879
2021-05-27,40682,26812,Sales,West,9,303,13870
2020-05-09,41707,25437,IT,East,4,299,16270
2022-10-04,14923,13437,HR,East,7,445,1486
2023-06-27,25920,12160,IT,West,7,426,13760
2022-01-03,31938,13575,Sales,East,9,62,18363
2022-08-04,23319,28593,HR,North,3,195,-5274
2023-03-07,16900,5284,Operations,West,1,55,11616
2023-07-22,12160,20315,Sales,North,8,363,-8155
2022-09-28,26236,10083,Operations,South,4,49,16153
2021-04-08,16221,25378,IT,North,2,106,-9157
2020-05-20,35294,13491,HR,West,5,433,21803
2023-07-03,20038,5900,IT,South,4,78,14138
2022-05-31,29651,6459,HR,East,1,375,23192
2021-03-31,33360,18680,Marketing,North,7,417,14680
2021-03-09,18255,24305,IT,North,4,284,-6050
2020-06-21,12699,7533,IT,West,8,57,5166
2021-04-17,31928,11579,IT,East,9,169,20349
2023-12-17,10372,22189,Finance,West,8,376,-11817
2022-10-16,28898,12595,Sales,East,1,376,16303
2022-07-05,33855,23612,Finance,West,8,207,10243
2021-03-14,44758,6921,HR,East,5,260,37837
2022-10-12,19607,9972,HR,South,1,276,9635
2022-12-16,49558,7387,HR,West,9,373,42171
2021-05-12,18553,15730,Sales,South,9,345,2823
2020-06-17,15383,19830,HR,West,7,163,-4447
2022-09-15,10715,6996,Finance,West,7,244,3719
2021-07-14,19837,9825,Finance,West,1,250,10012
2021-03-03,23950,10282,IT,North,9,309,13668
2021-02-22,17992,18869,Operations,West,1,39,-877
2023-10-02,36817,23887,Marketing,East,7,309,12930
2021-03-30,43818,20451,HR,North,9,121,23367
2021-12-14,23357,5104,Sales,East,9,86,18253
2020-07-20,14742,28246,Sales,East,5,99,-13504
2020-06-27,23369,13630,HR,East,6,374,9739
2020-02-26,15044,22905,Operations,East,2,246,-7861
2022-08-03,20288,6351,Finance,East,2,495,13937
2021-05-15,35378,7698,HR,South,9,348,27680
2022-01-08,17261,24996,Sales,North,1,394,-7735
2020-04-21,28064,21892,Marketing,East,5,208,6172
2023-03-17,19799,20300,Operations,South,7,113,-501
2021-12-15,13522,10310,HR,South,6,471,3212
2023-11-02,23690,11190,Marketing,East,6,83,12500
2022-05-26,12057,18166,HR,West,6,65,-6109
2023-10-03,45489,22658,Operations,East,8,1,22831
2023-10-13,47589,7822,Sales,South,7,437,39767
2022-12-15,45331,21447,Finance,East,5,174,23884
2022-03-23,24559,8921,Finance,South,2,250,15638
2023-09-01,23692,22243,Operations,East,6,410,1449
2022-08-21,10202,16019,IT,South,5,226,-5817
2023-04-23,43709,6547,Finance,East,4,386,37162
2022-12-13,26972,7076,HR,West,5,284,19896
2020-02-06,19537,18962,Marketing,West,9,84,575
2022-10-09,11642,21820,Marketing,South,2,490,-10178
2023-07-17,11365,27469,Finance,West,6,239,-16104
2022-05-12,10008,18908,Operations,West,9,411,-8900
2022-01-01,38820,8657,Operations,North,5,28,30163
2023-06-05,43803,22146,Operations,East,6,380,21657
2023-12-22,28001,5735,Marketing,East,4,287,22266
2022-03-20,16722,12214,Sales,West,5,431,4508
2022-10-21,30100,28968,Marketing,West,8,391,1132
2020-01-23,27460,16856,Sales,South,1,328,10604
2022-03-06,33987,9094,Operations,East,1,480,24893
2021-05-10,14015,27978,IT,North,4,459,-13963
2022-06-18,49897,9728,Marketing,North,3,304,40169
2021-02-28,12962,8729,Operations,West,5,282,4233
2021-11-30,14840,12241,Marketing,South,8,183,2599
2020-01-18,30533,22460,Operations,South,1,345,8073
2021-09-18,30454,15472,Marketing,East,5,135,14982
2022-11-28,15699,6830,HR,West,5,468,8869
2023-05-18,15922,15090,Marketing,West,2,361,832
2020-07-29,34919,22057,HR,South,5,57,12862
2021-07-18,36508,21932,Sales,North,8,115,14576
2022-08-29,31664,19432,Marketing,North,7,186,12232
2023-07-28,42270,5895,Sales,East,2,478,36375
2020-05-12,35278,23953,IT,West,6,376,11325
2021-03-24,24862,22297,Finance,West,1,1,2565
2020-09-20,23598,22560,Finance,North,3,338,1038
2020-04-20,11898,12273,HR,West,6,456,-375
2022-04-29,32939,11696,Marketing,West,9,29,21243
2023-06-15,41288,26249,Finance,South,1,232,15039
2022-06-19,34774,25690,Sales,East,6,150,9084
2022-01-28,12822,24657,Finance,East,2,480,-11835
2022-05-10,47252,27960,Finance,East,9,424,19292
2022-06-15,35049,20042,Operations,South,2,190,15007
2022-05-11,31884,19900,Finance,East,3,270,11984
2023-04-11,23052,17434,Sales,East,2,248,5618
2020-07-11,28038,22906,Finance,North,4,386,5132
2021-05-29,26975,27809,Marketing,North,4,419,-834
2022-02-28,44616,12477,Finance,East,1,327,32139
2022-08-25,23269,7802,IT,South,8,195,15467
2023-12-03,13041,8122,Finance,South,5,381,4919
2020-03-24,26551,17782,HR,South,8,255,8769
2022-03-08,14379,7456,Operations,West,6,79,6923
2020-03-20,17661,23033,Sales,West,2,363,-5372
2023-05-17,16967,7320,Finance,South,7,98,9647
2021-06-05,39870,15697,Finance,North,9,150,24173
2023-05-07,25674,22527,Marketing,West,7,274,3147
2020-08-21,30394,16964,Marketing,South,5,302,13430
2020-08-31,23531,13237,HR,West,4,338,10294
2023-11-17,31370,24698,Operations,West,8,447,6672
2022-04-28,28565,9406,Sales,West,6,123,19159
2021-01-27,10832,23993,Sales,West,5,98,-13161
2020-01-09,27405,12591,Sales,South,7,164,14814
2021-09-04,20185,8119,HR,West,3,46,12066
2022-03-17,13492,22784,HR,East,9,359,-9292
2021-12-15,10288,29583,Finance,South,4,239,-19295
2023-03-22,11076,24981,Operations,South,4,230,-13905
2020-04-19,44139,26873,Sales,South,8,293,17266
2022-04-13,11074,8511,Sales,West,6,244,2563
2020-09-22,47702,8828,Finance,South,1,18,38874
2023-10-28,37535,21949,Operations,North,2,171,15586
2023-03-21,42807,12651,Operations,East,9,360,30156
2022-09-02,14274,14092,Operations,North,6,157,182
2022-08-12,38198,15370,Marketing,East,7,204,22828
2023-12-09,39859,16784,Operations,East,9,146,23075
2022-06-25,48264,7771,IT,West,3,479,40493
2023-09-11,45276,11777,HR,East,5,143,33499
2021-11-02,22018,5113,Operations,East,5,187,16905
2020-06-24,18072,5531,Marketing,North,7,488,12541
2021-06-08,23348,14714,IT,East,2,122,8634
2023-08-31,23952,8410,Marketing,South,4,350,15542
2022-12-26,10318,14236,Marketing,South,4,100,-3918
2022-08-09,21818,27223,Finance,East,8,284,-5405
2023-04-22,36011,29608,Marketing,South,3,437,6403
2022-11-24,28787,13324,Marketing,West,2,15,15463
2021-05-19,22516,16159,Sales,South,9,384,6357
2022-04-28,43496,6726,HR,West,4,43,36770
2022-08-20,44055,26454,Finance,East,9,289,17601
2023-01-04,46769,13217,Finance,West,6,386,33552
2021-04-16,18752,7648,Sales,West,1,187,11104
2021-06-06,11375,17832,IT,East,3,8,-6457
2022-05-29,24970,14453,Sales,East,7,112,10517
2023-07-30,42792,7065,Finance,West,9,33,35727
2020-09-30,27538,5933,IT,North,8,419,21605
2020-02-23,22657,6050,Finance,East,5,402,16607
2022-12-14,27843,27414,Operations,East,8,90,429
2022-06-06,25583,12116,IT,North,2,496,13467
2022-01-14,31491,26427,Finance,South,3,149,5064
2020-10-03,47474,27851,Sales,North,8,448,19623
2022-06-01,28540,16106,Finance,South,9,412,12434
2023-12-12,15979,24986,Sales,North,8,212,-9007
2021-09-23,17943,11878,IT,West,4,116,6065
2023-06-02,18911,5792,Sales,East,6,173,13119
2021-07-23,43873,16367,IT,North,5,20,27506
2023-07-02,13769,10963,Marketing,East,4,379,2806
2020-06-24,12479,14547,HR,South,9,132,-2068
2021-07-19,20112,6385,IT,West,3,292,13727
2023-03-15,14731,22444,Marketing,East,1,354,-7713
2022-02-09,21361,14563,Marketing,North,7,237,6798
2023-11-09,45940,29307,Marketing,North,8,77,16633
2020-09-18,42205,9138,Marketing,West,3,223,33067
2021-06-14,34569,22533,IT,South,3,436,12036
2023-10-26,17068,19344,Sales,West,6,126,-2276
2022-06-09,16557,12693,Marketing,West,2,39,3864
2023-05-05,46098,16394,Operations,East,6,327,29704
2022-08-05,48790,28876,Marketing,South,5,209,19914
2021-08-07,44826,11327,Sales,West,7,106,33499
2022-03-25,32074,8353,Sales,East,9,140,23721
2023-07-31,32155,18364,HR,East,9,249,13791
2020-10-28,46389,27353,HR,South,1,55,19036
2023-03-01,46759,20205,Marketing,South,7,118,26554
2023-02-17,40784,9628,Marketing,East,3,350,31156
2023-03-05,42401,24832,Finance,South,4,176,17569
2021-09-19,21565,10327,Finance,East,2,354,11238
2021-07-26,34700,19281,HR,South,1,470,15419
2021-06-12,25337,26433,Marketing,South,3,213,-1096
2020-02-03,21112,21452,Finance,South,9,265,-340
2021-06-15,23761,15058,Operations,North,1,140,8703
2023-05-16,18885,17093,IT,South,3,465,1792
2023-08-15,11376,24892,HR,North,5,464,-13516
2023-01-22,15939,21684,HR,East,3,325,-5745
2023-12-08,12846,20987,Sales,West,4,339,-8141
2021-01-05,16817,28181,Marketing,West,4,441,-11364
2021-02-12,17430,23984,HR,West,1,284,-6554
2023-11-07,36328,23537,HR,East,6,273,12791
2021-09-08,21151,19907,Finance,South,7,22,1244
2020-03-11,37619,26289,Operations,North,7,419,11330
2020-03-24,44484,17921,Marketing,East,6,369,26563
2020-07-27,37664,25402,IT,West,7,187,12262
2020-09-15,16780,19026,Operations,West,3,207,-2246
2023-06-16,13331,8082,IT,West,5,147,5249
2023-08-18,38604,12074,Sales,West,7,495,26530
2023-06-09,27762,22623,HR,North,5,434,5139
2022-07-20,33765,15560,Finance,West,2,154,18205
2020-10-08,47043,5459,Operations,North,6,108,41584
2021-01-28,31922,29366,IT,West,7,316,2556
2021-02-21,33694,24010,Marketing,East,2,300,9684
2023-05-14,20556,25147,Sales,North,8,440,-4591
2023-07-11,23555,28404,Sales,North,5,483,-4849
2023-08-27,20004,7801,HR,East,8,299,12203
2022-05-08,48190,21847,HR,West,3,151,26343
2021-09-17,30810,5997,IT,West,2,458,24813
2023-01-07,21188,27025,IT,South,7,406,-5837
2023-09-27,10247,11384,Sales,South,5,175,-1137
2021-07-15,30762,18223,IT,North,5,55,12539
2022-04-11,23811,20299,HR,South,8,267,3512
2023-01-23,13741,16198,Sales,East,9,311,-2457
2022-07-29,39052,6678,Sales,East,8,154,32374
2023-10-06,44319,5864,Marketing,East,2,385,38455
2020-03-02,16306,14382,Marketing,North,7,484,1924
2023-03-11,13005,29120,IT,East,5,190,-16115
2022-01-03,13322,7697,IT,North,7,149,5625
2023-02-08,26008,17107,HR,North,3,8,8901
2022-02-20,34870,7926,HR,East,4,148,26944
2023-03-26,22466,20735,Marketing,East,7,173,1731
2021-06-22,43161,19223,Sales,North,2,81,23938
2021-08-19,12739,12542,Operations,East,2,79,197
2020-01-09,46935,9429,Finance,South,1,469,37506
2020-10-02,23194,20362,Finance,North,1,321,2832
2020-08-14,14231,28794,Operations,West,1,60,-14563
2020-07-04,38268,18931,IT,North,6,451,19337
2021-08-13,11401,12218,Finance,East,5,95,-817
2023-05-24,18086,28409,Finance,East,8,312,-10323
2021-03-08,43673,7397,Operations,North,5,128,36276
2021-07-22,10529,23605,Operations,North,1,122,-13076
2021-10-17,33462,19451,Marketing,West,8,287,14011
2020-12-21,47386,10814,Sales,West,6,341,36572
2022-04-22,26956,27888,HR,North,8,87,-932
2021-01-26,27027,12522,Marketing,East,2,382,14505
2021-08-01,30455,27169,Finance,North,8,81,3286
2023-07-22,49781,27603,HR,South,6,22,22178
2021-02-23,15605,25382,Marketing,South,1,252,-9777
2020-06-12,20677,24187,Marketing,East,1,190,-3510
2022-02-17,26938,20588,Operations,North,5,312,6350
2021-09-29,25009,17359,HR,North,7,86,7650
2023-04-21,40246,20762,Marketing,South,4,484,19484
2023-08-26,38185,20577,Operations,North,5,379,17608
2020-01-17,39295,25931,IT,East,3,456,13364
2021-03-21,35519,14970,HR,East,2,367,20549
2020-06-18,30952,11510,Marketing,West,2,8,19442
2023-07-27,19185,25045,Finance,East,5,318,-5860
2020-12-05,29843,20005,IT,North,4,334,9838
2021-12-26,27505,20919,Operations,North,2,230,6586
2022-10-31,38022,16561,Marketing,South,5,152,21461
2020-05-12,26439,15349,Finance,South,9,278,11090
2022-06-19,24660,21435,Operations,East,8,15,3225
2021-10-01,18849,11058,Operations,West,9,468,7791
2023-03-17,39628,16553,Finance,North,9,475,23075
2022-04-02,34835,8515,Operations,West,8,412,26320
2022-08-11,14736,8330,HR,North,9,406,6406
2020-03-19,45377,28875,IT,East,4,287,16502
2020-12-11,13909,6674,IT,East,8,457,7235
2021-08-31,24867,27412,Sales,South,2,248,-2545
2023-06-26,10794,16057,Marketing,West,9,255,-5263
2021-09-30,27945,22745,Operations,South,9,446,5200
2022-11-13,25369,13978,Marketing,East,3,343,11391
2023-05-09,33807,21939,IT,West,6,325,11868
2020-05-10,20856,20264,IT,North,7,365,592
2020-12-21,16795,19594,Operations,South,3,167,-2799
2022-08-01,39385,29176,HR,East,5,81,10209
2020-05-29,41063,14954,Finance,North,1,296,26109
2023-08-20,48260,7112,Operations,East,3,69,41148
2020-02-19,20149,23594,Operations,North,8,183,-3445
2021-04-08,36669,20523,Sales,South,3,327,16146
2023-06-17,36328,6701,Finance,North,8,64,29627
2021-03-30,47767,7712,HR,West,9,264,40055
2023-07-30,47965,27847,Marketing,North,6,327,20118
2020-11-30,13562,7316,Finance,East,7,86,6246
2023-10-07,43623,19659,HR,North,6,44,23964
2021-10-29,46389,11469,Operations,South,8,294,34920
2020-11-22,14206,6610,Operations,East,7,373,7596
2022-10-12,43806,25736,Operations,East,1,149,18070
2020-12-01,47364,11343,Operations,East,3,260,36021
2021-10-27,30897,20797,Operations,East,3,416,10100
2022-09-21,24151,26089,Finance,West,3,311,-1938
2020-03-21,14370,14319,Finance,East,4,349,51
2020-03-27,34045,26875,Finance,East,1,444,7170
2020-09-14,31700,14096,HR,East,2,59,17604
2022-09-17,46215,13355,Operations,South,5,94,32860
2020-07-03,32234,14328,IT,South,6,323,17906
2021-11-28,25326,9710,Finance,East,9,5,15616
2020-05-02,47997,7025,IT,West,2,83,40972
2023-01-24,12241,5105,Sales,North,9,328,7136
2021-08-27,40639,25843,Marketing,West,7,383,14796
2021-05-29,49766,24476,Finance,East,9,37,25290
2022-06-22,31278,15213,IT,East,4,479,16065
2023-10-26,16444,14344,Sales,West,7,27,2100
2020-10-31,13015,20842,HR,East,1,13,-7827
2023-10-12,24903,5698,Marketing,North,8,490,19205
2023-03-17,49583,16462,Operations,South,7,390,33121
2023-08-01,38143,13938,Finance,North,7,65,24205
2021-10-18,14864,11071,Finance,North,2,414,3793
2020-09-18,19676,27123,Operations,North,9,203,-7447
2021-05-05,14234,14152,HR,West,8,180,82
2022-01-07,31340,24875,Marketing,West,1,297,6465
2022-11-20,28723,8297,Finance,North,1,479,20426
2021-12-02,18526,24361,IT,West,5,464,-5835
2022-06-05,16842,5208,Marketing,East,2,271,11634
2023-07-15,44626,24700,Sales,South,1,389,19926
2020-01-12,11207,26791,Finance,West,8,15,-15584
2023-04-29,27308,12233,HR,West,4,1,15075
2023-11-24,15429,6891,IT,North,2,271,8538
2020-03-31,17591,19826,Marketing,South,5,484,-2235
2021-08-22,48660,8506,Marketing,East,6,444,40154
2020-10-27,21777,7039,IT,East,8,48,14738
2023-02-08,48713,24673,Sales,South,7,182,24040
2020-03-20,22548,14644,Sales,East,7,487,7904
2022-04-15,46795,11645,Marketing,South,1,183,35150
2021-10-13,47063,26145,Operations,North,3,328,20918
2021-03-08,42055,6617,IT,East,3,373,35438
2021-02-20,22869,13186,Finance,East,7,214,9683
2023-05-22,33863,5434,Sales,South,2,27,28429
2020-01-18,14661,15519,Finance,East,7,226,-858
2022-12-13,28782,23030,Sales,West,9,158,5752
2022-01-15,11898,16355,Sales,North,1,460,-4457
2020-08-27,22919,28051,HR,East,2,60,-5132
2022-04-25,12427,19328,Finance,East,6,66,-6901
2021-02-21,44393,10258,Operations,East,2,174,34135
2022-05-05,20767,17954,Sales,South,2,499,2813
2021-08-21,28420,12190,Operations,North,5,52,16230
2023-02-20,46123,22824,Marketing,North,7,486,23299
2021-02-23,14902,27479,Marketing,East,4,470,-12577
2020-08-03,36850,28259,HR,East,6,243,8591
2023-12-14,31620,25827,Operations,South,3,337,5793
2021-12-09,18280,20596,IT,North,4,291,-2316
2021-07-04,24954,26244,HR,West,4,244,-1290
2022-08-23,47729,17470,Sales,East,4,121,30259
2023-06-05,42800,15747,Marketing,West,1,42,27053
2023-06-14,47466,17188,Marketing,West,4,184,30278
2023-09-15,18887,12713,IT,North,4,45,6174
2022-04-12,41607,5380,HR,West,6,52,36227
2021-11-10,42141,14016,Operations,East,9,151,28125
2021-05-01,23335,28557,Marketing,East,6,413,-5222
2021-09-14,16177,16567,Sales,South,6,29,-390
2023-12-09,13926,6637,IT,North,7,57,7289
2020-08-06,20154,17479,IT,North,7,498,2675
2021-12-21,12959,28927,Finance,West,1,275,-15968
2021-01-15,28611,5524,IT,East,8,209,23087
2020-03-27,44161,24491,Sales,East,1,8,19670
2022-03-25,28407,29526,IT,South,9,434,-1119
2021-02-14,23025,6093,Operations,West,4,391,16932
2021-11-21,16064,5104,Finance,East,9,247,10960
2022-10-09,16639,23123,Operations,North,8,395,-6484
2021-06-08,12478,24510,HR,South,9,195,-12032
2021-03-22,17929,23060,HR,North,6,322,-5131
2020-10-26,42326,29288,Operations,South,9,339,13038
2021-02-11,32837,15546,Sales,North,4,412,17291
2021-01-09,39974,29411,Finance,West,3,440,10563
2020-08-20,18418,9916,HR,East,3,28,8502
2021-09-29,27650,17323,IT,North,8,345,10327
2021-10-11,44825,24318,Operations,West,2,331,20507
2022-08-18,24383,18336,Marketing,North,6,296,6047
2022-12-08,41708,10156,Sales,West,9,235,31552
2020-07-04,45709,22426,Sales,South,9,130,23283
2023-05-13,42924,16626,Operations,West,8,76,26298
2020-03-18,33382,23229,Marketing,North,8,445,10153
2023-11-10,36649,8501,Sales,East,1,233,28148
2020-07-12,41140,22925,Finance,South,7,230,18215
2023-01-31,42563,21850,HR,South,1,332,20713
2023-10-31,40373,7944,Finance,West,9,370,32429
2020-10-13,27144,25678,Marketing,North,3,409,1466
2020-09-06,18965,20905,Finance,West,1,485,-1940
2023-05-09,32791,6591,IT,South,8,351,26200
2021-06-19,33115,18522,HR,East,7,310,14593
2020-10-26,27341,21153,Marketing,West,2,401,6188
2023-01-11,26637,9072,Operations,North,7,432,17565
2022-03-19,34269,8572,Sales,West,5,396,25697
2021-04-02,27953,10978,HR,West,7,189,16975
2021-11-21,37794,5293,Operations,West,7,478,32501
2023-08-14,33877,27242,Marketing,East,2,2,6635
2023-10-19,22405,6338,IT,North,2,336,16067
2021-12-18,37812,21151,Sales,North,7,65,16661
2020-02-09,19973,20380,Sales,South,3,52,-407
2023-09-25,33925,18045,HR,South,4,34,15880
2020-04-17,33091,26593,Operations,West,7,301,6498
2023-09-01,29584,24859,Marketing,South,2,240,4725
2023-02-11,49325,7498,Marketing,North,2,129,41827
2023-04-05,19071,20113,Operations,West,9,243,-1042
2020-09-17,15088,10728,Sales,South,1,356,4360
2023-06-01,26550,28701,Operations,East,3,308,-2151
2023-07-09,12063,23877,Finance,South,4,323,-11814
2023-06-28,37280,8088,Marketing,East,5,98,29192
2021-06-09,18303,11281,Operations,South,3,76,7022
2021-12-10,21631,28179,Sales,North,9,312,-6548
2020-05-05,11125,20186,HR,South,5,442,-9061
2023-05-14,45409,27011,Finance,East,7,365,18398
2023-03-09,32485,17839,Sales,East,7,219,14646
2022-12-21,22794,25374,IT,South,9,306,-2580
2023-07-30,28018,25135,IT,West,2,101,2883
2020-02-23,18862,28625,Operations,East,3,119,-9763
2020-12-11,45879,23481,Sales,North,4,409,22398
2020-05-15,11690,24558,Sales,South,8,140,-12868
2020-11-25,25740,21771,Marketing,East,1,371,3969
2023-03-13,33024,5298,HR,South,9,225,27726
2023-12-30,30341,25818,Finance,South,5,255,4523
2023-07-29,19156,16652,Sales,West,4,73,2504
2020-05-15,47214,9061,Finance,South,8,449,38153
2022-03-23,41053,5473,Operations,South,9,312,35580
2022-05-01,20158,21161,Marketing,South,3,306,-1003
2023-11-25,12808,10057,Finance,North,4,471,2751
2022-05-20,15402,18079,Finance,South,1,156,-2677
2022-06-10,11964,16405,Finance,North,3,259,-4441
2021-09-26,27206,21168,Finance,South,5,422,6038
2021-10-30,19629,10289,Finance,West,8,64,9340
2023-07-17,42337,25492,Marketing,West,1,310,16845
2022-11-06,44829,13640,Operations,East,1,36,31189
2020-09-25,31559,7221,Finance,South,3,248,24338
2022-05-10,13865,15174,Finance,West,9,428,-1309
2021-04-26,14294,26635,Operations,West,9,44,-12341
2023-05-27,22965,24995,Sales,South,1,453,-2030
2023-09-04,22228,24026,Sales,East,4,119,-1798
2023-06-15,41377,23304,Marketing,North,8,349,18073
2020-10-11,44927,12075,Marketing,West,2,181,32852
2022-11-26,22822,27378,HR,West,4,397,-4556
2020-04-12,40070,7316,Marketing,North,7,428,32754
2023-12-24,13187,22658,Operations,West,7,388,-9471
2022-03-02,17135,18681,Finance,North,5,70,-1546
2020-08-26,23508,19953,Operations,North,7,435,3555
2022-01-10,43557,9983,HR,East,6,358,33574
2021-10-06,44090,12834,IT,North,2,454,31256
2023-02-22,49441,25002,IT,North,9,267,24439
2022-05-31,49884,15498,Operations,North,5,219,34386
2021-08-29,36067,21643,IT,North,2,438,14424
2020-07-06,28043,8206,IT,West,6,366,19837
2022-06-06,40572,20820,HR,North,5,190,19752
2023-07-03,19507,14704,Finance,West,2,256,4803
2022-09-13,13062,17930,Marketing,South,7,187,-4868
2022-07-12,34700,15320,Marketing,South,2,227,19380
2022-03-04,28454,10178,IT,North,7,61,18276
2021-06-13,20868,10358,Sales,East,6,168,10510
2021-11-06,12553,9507,HR,East,4,132,3046
2021-01-26,39553,27842,Finance,West,4,155,11711
2023-06-30,38511,28925,Finance,West,6,272,9586
2021-11-02,27428,8508,IT,South,9,210,18920
2022-05-10,15957,28689,Sales,West,6,7,-12732
2023-04-14,14578,17902,Sales,East,6,11,-3324
2021-04-10,48389,26378,Finance,South,1,200,22011
2022-04-18,44734,20238,HR,North,5,251,24496
2022-09-14,20548,29807,Marketing,West,1,64,-9259
2023-08-05,31353,11754,Finance,North,9,180,19599
2022-12-09,28634,13921,Finance,West,4,128,14713
2020-01-04,21679,16204,Operations,East,2,262,5475
2022-05-01,34717,10516,Sales,West,9,120,24201
2023-05-31,35579,27252,Operations,East,6,48,8327
2023-07-09,36730,10799,Operations,East,3,69,25931
2021-06-18,44782,7929,HR,North,2,377,36853
2022-06-21,14624,18885,Finance,West,6,262,-4261
2023-10-31,33103,29893,Marketing,North,6,230,3210
2022-12-20,35544,6530,HR,East,9,252,29014
2023-10-11,38534,29297,Sales,East,5,445,9237
2021-10-07,48636,14302,Marketing,East,9,450,34334
2020-01-24,43572,21138,Finance,East,5,479,22434
2023-08-09,38560,5715,IT,South,2,231,32845
2021-07-10,43435,14533,Marketing,East,1,224,28902
2021-11-21,43152,12527,HR,West,9,457,30625
2020-12-21,29638,24696,HR,East,7,207,4942
2022-05-19,46208,12223,Operations,South,3,341,33985
2022-07-29,26396,18421,Finance,West,6,366,7975
2021-07-28,36783,19066,IT,South,4,437,17717
2020-01-29,15403,16279,Finance,South,9,28,-876
2020-12-22,33838,26576,Marketing,West,2,365,7262
2020-12-30,48919,28411,IT,South,4,219,20508
2021-08-30,22359,21585,Finance,East,1,389,774
2021-02-12,32614,7140,Operations,North,7,337,25474
2023-07-13,20057,14248,IT,North,4,101,5809
2023-08-07,10100,8671,IT,North,5,58,1429
2021-07-20,38655,13610,Marketing,West,1,24,25045
2023-03-22,14978,12370,IT,West,2,415,2608
2020-08-06,20988,23982,Operations,West,4,227,-2994
2020-06-21,24531,17022,Sales,North,2,169,7509
2021-08-30,49302,23328,Sales,North,1,489,25974
2022-11-01,21631,7929,HR,West,1,246,13702
2023-10-17,21693,15959,Sales,North,6,324,5734
2022-05-07,45935,8383,Marketing,South,2,212,37552
2021-10-18,48148,24924,HR,South,3,363,23224
2022-08-26,23823,21777,Sales,North,5,465,2046
2023-01-10,34696,16111,Sales,West,3,430,18585
2023-09-25,21629,20570,HR,East,6,266,1059
2021-03-16,13856,12010,Marketing,East,7,421,1846
2021-09-08,41051,28161,HR,North,6,405,12890
2020-08-13,11075,13823,Marketing,East,2,21,-2748
2021-01-05,30797,5321,Marketing,West,9,124,25476
2020-01-28,43469,26053,Finance,South,2,369,17416
2022-10-04,46116,23077,Operations,South,6,464,23039
2022-09-21,18185,22447,Sales,West,9,97,-4262
2020-01-16,37841,29305,Finance,East,9,138,8536
2023-07-24,16836,8111,Sales,North,2,492,8725
2020-11-28,34596,24645,Finance,South,9,338,9951
2021-04-27,32218,15985,IT,East,8,353,16233
2021-07-19,45017,8086,HR,East,7,93,36931
2023-08-04,20705,18435,Finance,South,8,95,2270
2020-04-23,29606,25195,Operations,South,8,24,4411
2020-02-07,31375,17162,Sales,North,1,380,14213
2021-03-29,36933,24735,IT,West,9,396,12198
2022-01-11,18118,28464,Operations,East,6,404,-10346
2020-06-14,45319,14150,Marketing,North,1,454,31169
2021-11-24,36649,9143,Sales,South,1,136,27506
2020-07-23,12214,11332,Finance,West,7,334,882
2022-05-27,18534,11447,HR,West,2,133,7087
2020-09-01,45228,14774,Operations,East,6,54,30454
2023-09-18,13255,12863,IT,West,5,292,392
2022-07-31,37841,8176,HR,South,5,112,29665
2023-11-20,15334,7416,Marketing,South,6,422,7918
2022-03-31,22281,12668,HR,South,8,131,9613
2021-05-21,49598,13651,IT,North,5,420,35947
2022-07-12,49708,15486,Marketing,South,8,278,34222
2023-02-18,40697,23695,IT,North,5,264,17002
2023-07-06,20722,6229,Sales,South,6,445,14493
2021-02-13,46400,6530,IT,South,8,382,39870
2020-11-05,26029,17817,HR,West,2,78,8212
2020-03-08,10014,14579,Sales,East,7,263,-4565
2020-04-23,21506,7797,Sales,South,3,68,13709
2020-08-07,18208,6363,Operations,West,9,62,11845
2020-08-07,37157,9502,HR,West,7,403,27655
2021-12-30,19971,21836,HR,East,3,363,-1865
2022-01-18,33183,25288,Marketing,West,8,175,7895
2022-07-31,32963,27380,IT,West,2,280,5583
2021-01-20,45847,18101,Finance,East,8,464,27746
2023-08-14,18127,21961,IT,North,7,390,-3834
2022-07-18,25646,25303,HR,East,5,236,343
2023-06-30,35355,16204,IT,East,4,136,19151
2021-02-08,28208,12317,HR,South,1,409,15891
2021-05-06,32713,8264,Sales,South,4,224,24449
2020-12-22,42267,23315,IT,North,6,89,18952
2023-12-22,13864,9242,IT,East,6,458,4622
2020-08-02,20661,29565,HR,East,2,107,-8904
2023-11-04,42559,17693,HR,North,9,41,24866
2022-01-21,20322,21566,Marketing,South,1,186,-1244
2022-04-06,16710,29811,IT,East,4,465,-13101
2023-05-22,41362,5637,Operations,North,4,188,35725
2023-01-26,42380,24389,HR,South,2,366,17991
2021-06-11,24386,24856,Operations,West,8,387,-470
2022-07-04,23338,21908,Sales,North,2,9,1430
2021-10-27,25316,27043,Sales,North,2,180,-1727
2021-12-10,34463,19202,Operations,East,2,186,15261
2021-06-18,20203,7370,Finance,West,1,444,12833
2021-07-07,14888,14476,Sales,South,5,82,412
2020-11-23,38192,23019,Operations,West,4,177,15173
2022-06-20,21325,14915,Marketing,East,2,94,6410
2023-04-03,29088,15638,Marketing,East,1,389,13450
2023-02-13,19386,25816,Sales,South,1,446,-6430
2020-05-29,49028,28851,Operations,South,2,116,20177
2022-11-21,21267,25598,Operations,South,1,160,-4331
2021-10-18,41809,14773,Operations,East,9,245,27036
2022-03-16,25419,15652,Finance,South,2,283,9767
2020-10-19,35480,21963,Sales,South,3,213,13517
2022-07-07,12904,20743,Finance,South,9,152,-7839
2021-11-19,43891,29234,Operations,North,5,166,14657
2022-08-14,23430,8941,HR,South,8,451,14489
2023-04-15,24999,13387,Operations,East,7,400,11612
2022-12-20,33319,13524,HR,North,6,143,19795
2021-02-19,30700,8091,Marketing,East,2,25,22609
2023-11-07,37633,9718,HR,West,4,200,27915
2021-08-20,29108,13849,Marketing,North,9,233,15259
2020-01-07,34055,26936,Sales,South,7,4,7119
2022-07-06,28642,26362,Finance,North,3,288,2280
2020-03-25,13646,22636,Finance,East,6,173,-8990
2022-02-12,23173,13715,Marketing,North,8,184,9458
2022-08-14,17025,15456,Marketing,West,8,251,1569
2023-11-22,22549,18277,Operations,South,8,291,4272
2023-11-17,24853,20950,IT,South,8,437,3903
2022-12-06,39952,7422,Marketing,West,6,286,32530
2023-09-26,21326,13227,HR,East,3,359,8099
2021-08-28,13463,13967,Sales,North,9,112,-504
2021-03-01,37163,21411,Finance,East,3,305,15752
2021-03-01,42600,12539,HR,East,4,350,30061
2022-01-05,24075,5085,Finance,East,1,465,18990
2022-03-01,38709,11909,Sales,South,2,339,26800
2021-05-29,47709,25665,HR,North,6,436,22044
2023-02-26,26010,18316,Finance,South,1,479,7694
2023-06-26,10897,9653,Marketing,South,9,465,1244
2022-01-10,10605,13033,IT,South,8,130,-2428
2020-05-10,46445,29048,Marketing,North,2,187,17397
2020-11-18,47315,15748,Finance,West,2,421,31567
2022-04-02,18652,18925,Operations,South,8,496,-273
2021-06-26,42229,10066,HR,South,8,29,32163
2020-03-06,40530,17504,IT,South,1,158,23026
2021-12-18,48024,20896,HR,North,5,374,27128
2023-01-29,30414,21640,Operations,North,2,235,8774
2020-01-31,37903,16998,Operations,East,1,278,20905
2022-06-03,24730,18764,Operations,South,3,102,5966
2020-07-09,47924,6447,Finance,South,3,459,41477
2021-02-18,48541,17611,Marketing,North,9,225,30930
2022-01-16,37898,20858,Finance,North,1,275,17040
2022-12-05,25930,10700,Marketing,South,2,323,15230
2023-01-17,13518,25983,IT,West,9,232,-12465
2021-01-09,40982,8343,Operations,East,5,342,32639
2023-06-23,16775,22077,Marketing,East,9,274,-5302
2021-07-11,33990,15257,Sales,South,6,365,18733
2023-07-04,15378,19442,Sales,East,3,478,-4064
2023-10-07,49441,16792,Marketing,East,8,449,32649
2023-02-02,16444,17412,IT,South,9,468,-968
2023-09-22,24176,8665,HR,East,2,113,15511
2023-08-17,35060,7674,Finance,North,9,389,27386
2023-01-05,19379,15590,Operations,South,4,460,3789
2023-06-07,46495,21734,Marketing,North,8,139,24761
2021-07-31,37568,13840,IT,South,5,216,23728
2020-02-01,32765,17062,Finance,North,6,314,15703
2020-02-27,40802,12044,HR,East,4,274,28758
2023-02-01,33196,29803,IT,West,5,328,3393
2020-11-07,25468,7063,HR,North,1,349,18405
2022-12-26,38849,27313,Sales,North,3,184,11536
2021-11-20,47113,18011,Finance,West,4,406,29102
2023-10-29,18174,12413,Finance,West,1,312,5761
2020-08-22,29098,23205,HR,North,3,493,5893
2021-10-04,17046,26273,Sales,North,4,194,-9227
2023-02-09,14186,17464,Operations,North,9,279,-3278
2023-11-13,26722,15782,Marketing,South,3,272,10940
2023-12-02,15968,22969,Sales,North,3,300,-7001
2022-12-13,38270,14870,IT,North,4,72,23400
2022-03-12,49273,9659,HR,West,9,196,39614
2020-08-26,16387,7280,Finance,West,9,270,9107
2023-08-11,34394,8749,IT,South,1,393,25645
2020-04-21,21291,7538,Finance,South,8,331,13753
2023-01-16,40093,21827,Sales,East,1,240,18266
2021-04-20,12610,23451,Finance,North,2,486,-10841
2020-10-30,45241,16990,Finance,North,5,108,28251
2023-08-21,38337,29686,Finance,West,6,499,8651
2020-10-16,45456,7534,Finance,East,2,400,37922
2020-07-26,14804,5088,IT,North,5,397,9716
2022-05-17,44058,24774,HR,East,3,292,19284
2021-08-04,20227,26621,Marketing,South,7,300,-6394
2021-01-04,41334,11577,IT,North,1,100,29757
2020-08-07,16511,23325,Operations,North,5,81,-6814
2023-06-08,49440,24694,HR,South,3,270,24746
2022-03-12,29727,13263,HR,North,2,349,16464
2022-03-29,41139,22205,Operations,South,3,17,18934
2020-12-14,29794,13072,Sales,South,4,193,16722
2020-09-11,12981,22199,Operations,East,2,212,-9218
2021-03-27,22785,29979,Sales,West,2,353,-7194
2020-05-21,24666,23082,Marketing,West,3,126,1584
2022-12-28,45583,17538,Sales,South,2,310,28045
2020-03-29,15096,16108,Marketing,East,6,126,-1012
2022-05-20,23950,12362,Marketing,South,2,130,11588
2023-03-05,16673,15234,Finance,East,1,145,1439
2021-06-06,11742,10691,Finance,East,8,256,1051
2021-10-21,48488,27113,Operations,West,4,23,21375
2022-08-08,46277,6953,Marketing,West,2,214,39324
2022-06-28,13534,9963,Sales,East,4,129,3571
2021-03-17,24685,10986,IT,West,2,12,13699
2020-02-07,15136,12752,Finance,East,5,141,2384
2023-05-16,15585,16445,HR,North,7,462,-860
2020-07-28,37358,9991,HR,South,6,458,27367
2021-05-27,18554,25185,Sales,West,2,268,-6631
2023-10-15,11634,13447,Finance,South,4,57,-1813
2022-10-21,26908,6931,IT,West,8,86,19977
2022-09-07,31310,22495,Marketing,South,7,274,8815
2021-01-15,25117,5872,Finance,South,7,103,19245
2022-04-07,11722,12954,Sales,West,4,339,-1232
2022-05-08,18611,25971,Marketing,West,1,350,-7360
2021-01-28,13864,27863,Finance,West,7,143,-13999
2022-12-09,11067,22945,Operations,West,6,423,-11878
2021-01-30,35976,10526,IT,East,8,334,25450
2020-02-01,49206,17920,HR,West,5,329,31286
2021-06-28,17271,25841,Sales,West,8,453,-8570
2021-12-12,21828,10560,HR,West,8,417,11268
2023-06-11,41131,20389,Marketing,North,9,176,20742
2022-11-15,30386,29265,Marketing,South,1,133,1121
2023-12-28,11834,14085,Operations,West,3,344,-2251
2022-12-20,12353,12715,Marketing,West,6,264,-362
2021-07-06,23878,24068,Marketing,South,4,147,-190
2023-02-27,21132,14438,HR,South,8,436,6694
2023-10-09,18203,22130,HR,East,1,12,-3927
2020-07-16,20322,10243,Sales,South,5,328,10079
2022-03-09,21295,11826,Sales,South,4,392,9469
2021-11-24,45925,9085,Marketing,North,1,55,36840
2023-10-26,32247,11117,Finance,East,6,230,21130
2020-05-26,27340,22390,IT,North,3,468,4950
2021-05-12,30242,29513,Sales,South,5,122,729
2020-02-17,32522,25694,Marketing,West,6,349,6828
2022-02-08,22095,14082,Finance,East,4,233,8013
2021-10-12,33425,15683,Finance,South,6,162,17742
2023-04-10,44723,19884,HR,South,7,82,24839
2021-09-04,20204,7876,Finance,West,2,449,12328
2021-11-29,14991,23410,Operations,West,7,459,-8419
2023-08-31,41626,10556,HR,West,7,47,31070
2021-01-10,46833,25491,HR,East,2,364,21342
2022-03-16,26067,10241,Operations,North,3,291,15826
2022-07-09,23763,20906,HR,East,3,499,2857
2022-05-24,27408,19914,Sales,West,1,160,7494
2022-03-20,35176,10669,HR,East,1,179,24507
2023-12-14,45097,10399,Operations,West,6,362,34698
2022-06-23,45794,13933,Marketing,North,9,208,31861
2023-11-20,34231,18648,Marketing,East,9,390,15583
2023-04-25,11011,24392,Marketing,North,1,393,-13381
2022-10-02,33427,15168,Operations,North,7,40,18259
2020-02-02,48392,12495,Operations,West,6,214,35897
2020-03-09,25229,20605,Sales,East,4,432,4624
2021-08-14,23244,25046,Operations,East,3,456,-1802
2023-04-29,26602,26804,Finance,North,9,352,-202
2020-04-10,34462,19204,Marketing,West,5,154,15258
2023-08-01,35302,24295,Operations,North,8,338,11007
2022-07-02,33536,11897,IT,North,4,293,21639
2022-01-02,32210,16276,HR,North,4,436,15934
2021-01-24,15585,10485,Sales,North,6,396,5100
2020-06-08,27195,10838,Marketing,East,6,166,16357
2022-06-10,24837,22157,Finance,South,3,482,2680
2022-12-06,15456,7144,Finance,East,2,452,8312
2023-03-28,47289,19406,Marketing,West,9,272,27883
2021-11-26,19775,14184,Finance,South,2,445,5591
2022-01-27,24099,10980,IT,North,9,24,13119
2021-06-06,46805,19692,Sales,East,8,462,27113
2022-01-01,26815,19879,HR,South,7,401,6936
2020-06-03,22226,16513,Sales,North,5,115,5713
2020-12-04,40072,27781,Sales,East,3,351,12291
2023-10-20,19139,17034,Marketing,South,2,260,2105
2022-03-05,40060,13141,Operations,East,8,306,26919
2023-03-17,19859,20323,HR,South,2,364,-464
2022-06-17,12539,24621,Sales,West,8,226,-12082
2023-03-13,23199,13195,IT,East,5,102,10004
2020-04-12,43158,26966,Marketing,East,9,486,16192
2022-03-22,10082,27672,Operations,South,4,131,-17590
2020-04-02,22281,13356,Operations,West,8,264,8925
2022-09-01,25120,17631,Marketing,East,7,12,7489
2023-08-02,19946,6897,Sales,West,8,419,13049
2023-12-18,20891,26817,Finance,West,5,322,-5926
2020-04-28,29640,16432,Marketing,East,2,181,13208
2020-01-29,36111,23951,Finance,North,7,349,12160
2022-10-09,48775,13130,Operations,South,3,471,35645
2022-11-19,43290,27101,Operations,East,2,161,16189
2022-05-21,40604,16699,IT,West,3,114,23905
2023-10-21,44462,28136,IT,South,4,18,16326
2022-03-10,28636,7559,Operations,East,7,104,21077
2023-03-07,14837,19744,IT,South,1,186,-4907
2021-04-19,21801,14530,IT,South,6,342,7271
2021-07-16,33710,26021,IT,West,6,462,7689
2023-11-16,41621,21996,Operations,North,8,93,19625
2021-03-10,23065,29130,Sales,North,2,301,-6065
2022-03-14,38230,18187,Sales,South,2,143,20043
2023-06-11,46388,23268,HR,West,1,143,23120
2020-02-24,20631,25408,IT,West,3,301,-4777
2022-07-19,39828,8134,Sales,East,7,452,31694
2023-08-08,19131,23006,HR,South,8,100,-3875
2022-01-21,24307,21375,Marketing,East,7,453,2932
2020-11-07,13709,24666,IT,West,9,451,-10957
2023-01-17,30721,23994,Sales,South,8,460,6727
2023-05-20,42194,19910,Sales,North,8,62,22284
2022-08-14,15094,8069,Finance,North,2,84,7025
2020-11-13,19415,11486,Sales,East,1,428,7929
2022-01-26,23530,22639,Finance,South,6,276,891
2021-04-09,17472,7660,HR,West,7,167,9812
2023-01-15,46131,9452,Finance,East,6,295,36679
2023-12-03,29407,28486,Marketing,North,7,129,921
2023-06-17,28201,16869,IT,West,8,364,11332
2021-11-30,37948,9176,Sales,South,2,67,28772
2022-12-16,33115,8686,Operations,North,1,47,24429
2023-02-10,37961,10237,IT,West,8,457,27724
2022-01-04,12017,29045,Operations,North,8,374,-17028
2022-12-29,14223,5790,HR,South,8,310,8433
2022-01-08,44952,19827,Sales,East,7,148,25125
2022-02-06,33075,19186,IT,West,2,250,13889
2023-04-22,16531,13416,IT,West,4,137,3115
2022-01-13,14666,24418,Sales,South,9,95,-9752
2020-10-02,33781,19754,Marketing,North,8,238,14027
2020-08-20,45236,18067,HR,North,4,284,27169
2020-02-23,46688,21609,Sales,North,8,320,25079
2020-09-13,14236,26732,Finance,West,6,35,-12496
2020-03-30,11939,27850,IT,West,9,296,-15911
2023-12-29,46624,24563,Marketing,North,1,381,22061
2021-02-11,42818,14003,IT,West,6,358,28815
2023-07-16,25926,19228,Operations,East,4,492,6698
2020-12-31,37552,9223,IT,South,3,258,28329
2020-12-16,40100,28904,HR,South,5,387,11196
2023-08-15,11360,9066,Sales,West,8,270,2294
2023-03-28,49573,25746,IT,East,6,465,23827
2021-05-01,21994,26407,Finance,East,1,355,-4413
2022-04-21,34941,25693,Operations,North,6,324,9248
2022-09-10,37531,5246,Operations,South,7,47,32285
2023-10-10,45813,27121,Sales,South,6,94,18692
2021-09-12,21093,23002,Operations,South,3,182,-1909
2022-07-18,43025,16637,Sales,West,9,442,26388
2021-02-04,21651,13612,HR,East,4,190,8039
2023-11-29,42812,10160,Sales,North,5,487,32652
2023-01-24,34844,6371,Marketing,West,5,51,28473
2021-07-23,27718,12728,Operations,North,3,206,14990
2022-09-01,23589,9238,Operations,West,2,304,14351
2021-01-26,49768,23996,Finance,South,8,411,25772
2020-12-17,30022,23464,IT,North,7,333,6558
2022-03-16,48853,10919,Marketing,East,5,439,37934
2021-07-29,10234,9324,IT,East,1,125,910
2022-02-15,16834,12797,Sales,West,1,212,4037
2021-09-24,25055,24119,HR,South,8,369,936
2023-08-04,13207,27467,Finance,West,4,433,-14260
2021-06-06,12400,28736,Operations,North,4,408,-16336
2021-12-26,19609,14021,HR,East,9,266,5588
2020-06-10,31473,8058,Sales,East,2,135,23415
2021-10-20,33935,14041,Sales,East,5,372,19894
2023-04-20,33874,10334,Marketing,East,6,273,23540
2022-04-29,35015,6153,IT,North,6,278,28862
2020-03-22,24184,9940,Operations,East,3,315,14244
2021-06-07,39543,19607,Operations,West,6,300,19936
2020-01-04,10650,17021,HR,East,5,267,-6371
2021-05-09,42389,8079,Marketing,North,8,298,34310
2022-12-10,37328,21786,Finance,South,4,279,15542
2023-07-08,29416,24359,Sales,South,3,374,5057
2023-03-03,23119,17914,Marketing,East,6,444,5205
2023-10-17,17644,12536,Operations,South,9,214,5108
2021-07-21,18653,27303,Finance,North,8,488,-8650
2023-05-25,24416,28144,IT,East,8,62,-3728
2022-05-27,34897,5980,HR,North,3,367,28917
2022-12-27,11874,11680,Sales,South,1,54,194
2022-10-08,20429,18364,Sales,South,3,338,2065
2022-10-11,22213,15486,Sales,East,3,375,6727
2022-05-13,27640,7384,IT,South,6,365,20256
2023-03-12,46008,16544,Operations,East,3,474,29464
2023-10-01,25802,17320,Operations,East,2,112,8482
2022-02-17,26122,13990,Marketing,West,9,478,12132
2023-05-02,31653,15787,Finance,West,6,269,15866
2022-10-01,34101,6366,Marketing,West,5,324,27735
2023-06-23,11409,7938,Operations,North,3,107,3471
2020-11-09,44600,22646,Sales,South,7,283,21954
2021-12-30,28408,29043,IT,South,7,371,-635
2021-01-18,15736,11187,Operations,West,4,168,4549
2020-10-03,14993,13495,IT,East,2,74,1498
2022-12-31,41247,14885,HR,East,2,236,26362
2023-02-26,38821,23700,Sales,East,8,92,15121
2023-10-13,13213,20018,HR,East,4,85,-6805
2021-11-28,39495,29293,Operations,North,7,372,10202
2023-05-28,16208,22305,Marketing,South,3,75,-6097
2022-10-26,19644,12114,Operations,West,9,84,7530
2022-01-20,16453,11574,HR,North,9,245,4879
2022-09-09,21093,29996,IT,South,7,228,-8903
2021-09-15,21263,10529,Finance,North,7,83,10734
2020-08-15,10305,8809,Finance,East,1,394,1496
2020-01-17,44152,18536,Operations,North,8,15,25616
2020-01-12,42021,22550,Marketing,North,2,493,19471
2021-11-22,27958,13731,HR,East,8,301,14227
2020-03-10,10872,27652,Operations,East,2,181,-16780
2020-04-17,31962,10331,HR,West,1,338,21631
2020-07-19,27414,26413,HR,West,8,263,1001
2022-12-11,19926,22844,Sales,South,4,414,-2918
2021-09-20,49673,9687,Finance,West,6,78,39986
2023-07-06,47210,10357,Finance,West,1,229,36853
2023-07-11,25290,26123,IT,South,9,233,-833
2022-06-24,13667,5327,Sales,North,7,30,8340
2020-10-29,27660,26622,Finance,North,5,374,1038
2022-07-25,16553,15285,HR,North,6,155,1268
2021-07-29,26926,15323,Marketing,East,3,305,11603
2021-07-08,14808,29927,Marketing,South,9,185,-15119
2020-05-04,38612,26516,Sales,North,2,448,12096
2023-07-17,38015,26116,Marketing,West,1,357,11899
2022-05-08,43351,25292,HR,West,1,447,18059
2022-01-14,19138,10291,Operations,West,2,432,8847
2021-04-24,46241,13425,HR,South,6,255,32816
2020-05-11,11198,20540,Finance,South,6,169,-9342
2022-10-22,37447,8122,Operations,West,9,81,29325
2020-04-24,46763,9876,Marketing,East,4,286,36887
2021-04-25,22113,24112,IT,East,8,210,-1999
2022-09-07,38749,18706,IT,North,4,259,20043
2022-10-21,47303,14124,HR,North,3,476,33179
2020-11-26,48639,29379,HR,North,4,37,19260
2022-07-30,29687,6823,Marketing,North,1,286,22864
2022-08-12,12447,24884,IT,North,9,54,-12437
2022-02-06,19408,9073,IT,South,5,469,10335
2021-01-25,49612,22614,HR,South,7,369,26998
2022-04-13,27674,15387,Finance,East,3,212,12287
2020-05-22,22413,9395,IT,East,5,342,13018
2020-11-23,17549,11051,HR,South,4,484,6498
2021-09-19,33071,6476,Sales,East,7,100,26595
2021-01-11,18693,23407,IT,West,5,85,-4714
2020-03-30,26770,23980,Operations,East,2,472,2790
2022-03-18,12006,29224,Marketing,West,3,213,-17218
2022-10-17,15213,12121,HR,West,8,391,3092
2022-12-01,46636,7430,IT,North,3,264,39206
2022-11-24,19530,12954,IT,East,7,470,6576
2022-10-08,16637,28327,Finance,West,5,86,-11690
2021-07-06,14964,16881,HR,East,7,63,-1917
2020-05-03,44070,21917,Operations,East,9,447,22153
2020-02-26,17749,22640,IT,South,7,192,-4891
2022-03-16,10846,23041,Sales,South,6,414,-12195
2020-08-22,23390,17085,Marketing,North,1,482,6305
2021-08-30,23735,23136,HR,East,4,93,599
2021-01-26,33905,28097,IT,South,8,253,5808
2022-08-27,24876,7978,Finance,West,1,138,16898
2023-09-28,23967,9332,Finance,West,6,453,14635
2023-04-14,28262,25037,Marketing,North,2,49,3225
2020-02-21,46873,8013,HR,West,9,121,38860
2021-05-03,30014,20089,HR,East,8,39,9925
2020-01-05,34054,29036,HR,West,9,34,5018
2021-09-23,39955,28484,Operations,North,9,358,11471
2023-05-17,33051,19008,Sales,North,2,266,14043
2020-08-04,38385,26250,Finance,West,2,9,12135
2021-06-19,45587,23148,HR,East,9,188,22439
2023-09-27,37483,22506,Operations,South,2,96,14977
2023-11-25,37653,8830,HR,East,4,133,28823
2022-01-07,40894,28084,HR,East,2,163,12810
2021-12-30,39842,7958,Operations,East,1,139,31884
2023-05-19,29648,6540,Sales,West,7,298,23108
2022-11-15,41756,13714,Marketing,South,5,80,28042
2023-06-29,32407,16199,Finance,East,3,91,16208
2020-01-03,27058,26851,IT,South,8,256,207
2022-10-22,20070,12053,HR,North,5,148,8017
2022-10-22,49025,10670,Sales,South,1,179,38355
2020-05-29,43779,15690,Finance,West,9,257,28089
2020-01-04,26616,19262,IT,North,5,218,7354
2021-04-12,40373,20347,HR,North,3,267,20026
2020-03-10,44941,15281,IT,East,6,317,29660
2020-07-19,46152,23122,Operations,South,8,79,23030
2020-11-03,10797,25573,Finance,North,2,167,-14776
2023-06-29,49889,7533,Sales,North,3,104,42356
2023-08-03,23594,15756,Sales,South,7,304,7838
2022-07-10,17690,26653,Finance,South,2,338,-8963
2020-10-18,22669,23802,Marketing,North,5,472,-1133
2023-03-23,28973,10076,Marketing,North,9,284,18897
2022-07-12,31085,21868,IT,South,7,345,9217
2023-03-02,38787,22048,Operations,West,3,215,16739
2022-06-01,35084,24838,IT,South,2,75,10246
2021-08-08,34051,22011,HR,West,9,225,12040
2023-07-21,21554,14876,Sales,North,9,336,6678
2021-05-23,47639,9287,IT,East,9,292,38352
2023-10-08,23354,19056,IT,South,3,343,4298
2020-01-05,15289,20171,Finance,North,1,70,-4882
2020-10-19,34744,14436,Sales,North,9,363,20308
2020-12-25,27945,10166,Sales,East,7,190,17779
2020-08-01,34243,15366,Marketing,South,2,472,18877
2023-11-30,49054,25258,Marketing,North,6,486,23796
2023-12-30,34227,15966,Sales,West,9,106,18261
2022-11-04,37748,17983,IT,East,8,70,19765
2023-07-20,26958,17310,HR,West,6,10,9648
2021-07-16,19934,16390,IT,South,6,214,3544
2022-02-03,20550,25924,HR,West,8,471,-5374
2020-02-14,14024,18064,Sales,East,9,5,-4040
2021-12-03,41772,15236,Finance,North,8,28,26536
2021-09-25,18722,12476,HR,East,1,315,6246
2023-12-06,12120,5707,Marketing,North,2,393,6413
2023-04-25,40089,13624,Finance,North,6,423,26465
2021-10-22,31348,21325,Sales,West,8,241,10023
2023-04-08,15877,5047,Operations,East,4,236,10830
2021-12-21,28904,6914,HR,East,4,92,21990
2021-08-16,30792,22489,HR,North,2,318,8303
2023-11-25,36037,24564,Finance,East,1,345,11473
2020-09-02,27335,20390,Operations,South,9,363,6945
2022-05-06,24659,29933,Operations,South,7,38,-5274
2021-07-05,39684,21951,Sales,West,9,219,17733
2020-02-12,10964,13671,Finance,West,2,152,-2707
2022-04-20,44902,22250,IT,East,5,192,22652
2020-06-27,45012,16452,Operations,West,2,121,28560
2021-06-18,45571,6028,HR,East,7,491,39543
2021-08-29,13911,6813,Operations,West,9,171,7098
2021-11-02,21216,25112,Sales,South,3,110,-3896
2023-06-21,11408,10513,Sales,North,1,144,895
2022-07-15,31621,24910,HR,North,4,66,6711
2020-01-17,30977,26187,HR,South,4,322,4790
2023-02-09,23195,27953,HR,North,6,197,-4758
2022-04-05,17113,6050,IT,East,5,46,11063
2021-06-30,32761,29702,HR,East,5,149,3059
2022-11-19,34992,11278,Finance,South,9,60,23714
2023-04-30,23778,16798,Sales,South,1,138,6980
2021-03-12,31985,23036,Sales,South,8,490,8949
2020-06-27,14367,19727,Operations,South,8,402,-5360
2021-09-07,20786,29583,HR,North,8,90,-8797
2021-11-07,40908,9708,IT,North,3,212,31200
2021-09-25,21051,14476,Finance,North,8,169,6575
2023-03-03,46746,10318,Marketing,East,2,420,36428
2022-03-12,25611,10859,Operations,West,8,113,14752
2020-11-07,14490,17673,Finance,East,8,341,-3183
2020-01-25,41313,27999,IT,West,3,66,13314
2021-01-05,16377,29754,HR,South,4,302,-13377
2021-06-08,19903,11593,IT,South,9,118,8310
2023-09-04,24567,24979,Marketing,North,9,225,-412
2020-08-17,32885,9910,Finance,North,9,151,22975
2023-01-30,38222,8254,IT,West,6,167,29968
2021-01-12,36606,9453,Marketing,West,1,95,27153
2022-06-06,27440,23807,Marketing,North,8,260,3633
2023-05-11,12260,29492,Finance,South,9,425,-17232
2023-07-14,40267,26181,Marketing,North,8,259,14086
2021-04-06,37002,28365,Finance,South,1,485,8637
2020-12-30,26833,12937,IT,South,6,437,13896
2020-04-13,13498,28065,HR,East,9,120,-14567
2023-02-08,20518,26261,Sales,East,9,74,-5743
2021-03-03,22501,9177,Sales,West,7,362,13324
2021-04-13,32254,8429,IT,South,7,96,23825
2022-10-11,44076,5184,HR,North,4,292,38892
2022-05-19,25902,8133,Sales,South,7,177,17769
2022-02-08,43485,9978,Marketing,West,5,27,33507
2021-11-10,35545,13698,IT,South,5,309,21847
2022-03-15,13345,27521,IT,South,1,305,-14176
2022-06-04,25370,18773,Operations,West,2,211,6597
2021-07-14,38231,23316,Operations,South,9,358,14915
2023-06-27,19642,11174,Operations,East,2,257,8468
2020-11-26,27839,26796,Finance,West,2,474,1043
2021-08-09,33681,22580,HR,East,9,430,11101
2020-07-19,17035,16877,IT,West,3,318,158
2021-03-29,43299,26631,Operations,South,2,205,16668
2022-04-05,45035,25565,IT,East,7,355,19470
2020-04-20,33583,22722,Marketing,East,9,66,10861
2022-05-13,32105,27555,Operations,North,6,150,4550
2022-06-26,26130,19457,IT,East,7,167,6673
2023-05-17,23736,18562,HR,East,3,220,5174
2020-02-02,23815,24004,Finance,South,3,300,-189
2021-07-08,34396,11546,HR,East,8,258,22850
2020-04-16,34312,16706,HR,East,7,203,17606
2023-07-12,22244,27315,Operations,East,5,240,-5071
2020-08-13,21718,15352,HR,South,6,315,6366
2021-05-01,26784,6729,Finance,West,9,229,20055
2020-06-27,40683,14609,Sales,South,3,474,26074
2023-05-30,41428,17206,Finance,East,3,156,24222
2023-10-25,46759,5018,Marketing,West,6,218,41741
2021-09-28,36490,27355,Finance,South,8,465,9135
2022-02-26,26410,21848,IT,South,5,195,4562
2020-06-15,45386,13882,Sales,West,1,270,31504
2021-10-24,19362,21268,Operations,North,3,16,-1906
2020-10-26,49407,10310,IT,East,8,241,39097
2023-11-05,34011,18804,Finance,North,4,252,15207
2020-02-04,17042,29463,IT,East,9,51,-12421
2021-02-10,35286,16253,HR,East,6,356,19033
2020-11-09,21391,25404,IT,North,4,28,-4013
2022-03-26,36999,21546,IT,North,4,476,15453
2022-01-12,12018,14827,Finance,East,5,53,-2809
2021-12-27,22952,15938,Marketing,West,7,308,7014
2022-04-05,26240,5294,Finance,West,7,116,20946
2023-01-29,31262,12240,Operations,North,7,409,19022
2021-07-22,29282,11844,Sales,North,5,441,17438
2023-05-23,32459,6585,HR,South,9,9,25874
2021-07-29,44815,24764,Marketing,West,2,11,20051
2020-03-02,27942,15541,Sales,West,8,485,12401
2021-01-03,11722,10427,Sales,East,8,107,1295
2023-10-23,46820,28196,Marketing,South,3,301,18624
2020-04-03,11651,20620,HR,East,5,341,-8969
2022-09-10,31606,21578,Operations,South,8,258,10028
2022-11-15,44546,14033,Marketing,West,9,182,30513
2023-12-29,10683,19154,Marketing,East,7,418,-8471
2023-02-18,28394,21336,Marketing,South,4,170,7058
2020-02-19,28966,17199,HR,East,4,461,11767
2022-06-01,36469,17776,Marketing,South,3,325,18693
2022-02-02,18505,27727,Marketing,North,8,139,-9222
2020-02-05,15492,7931,IT,East,6,285,7561
2023-12-04,26827,19843,IT,North,6,111,6984
2023-08-05,37492,28425,IT,South,9,92,9067
2023-11-03,13266,10699,IT,East,3,220,2567
2020-04-09,15909,29655,Marketing,South,4,5,-13746
2023-09-09,22869,26224,IT,South,3,20,-3355
2020-11-24,49782,12636,Sales,North,3,101,37146
2021-12-06,31863,6860,Operations,East,1,295,25003
2020-08-08,17819,26945,IT,West,6,458,-9126
2021-07-20,39136,22314,HR,South,9,416,16822
2022-09-22,24837,19989,Operations,North,5,157,4848
2022-10-18,20056,23318,Finance,West,2,450,-3262
2020-04-19,10715,20237,Finance,North,4,383,-9522
2020-05-28,27275,9367,Sales,North,6,1,17908
2021-02-09,30191,18654,Operations,North,7,212,11537
2021-11-29,26884,7171,Operations,South,7,119,19713
2022-10-13,18894,8294,Sales,West,4,385,10600
2023-12-04,28717,18801,Finance,South,5,260,9916
2023-02-26,28578,9747,IT,South,4,399,18831
2020-04-17,33321,9392,Sales,East,6,175,23929
2021-01-23,34959,10238,HR,West,7,414,24721
2021-02-28,20515,7834,Sales,East,2,134,12681
2021-03-22,19077,20435,Marketing,North,3,102,-1358
2022-07-06,31443,17908,Finance,West,8,385,13535
2022-12-27,20443,12116,Marketing,West,7,455,8327
2022-12-25,47208,7928,Finance,South,1,62,39280
2021-10-17,11783,28809,Finance,North,4,448,-17026
2020-11-16,23113,27134,Operations,South,5,389,-4021
2021-12-19,15385,11494,IT,East,3,54,3891
2021-12-28,46885,6672,IT,North,4,305,40213
2021-08-02,16982,13190,Finance,South,7,7,3792
2021-03-22,45351,28828,Finance,South,8,356,16523
2020-07-28,23407,9350,Marketing,South,9,3,14057
2022-04-28,25316,6287,HR,North,2,332,19029
2021-01-04,34838,15918,Sales,East,4,379,18920
2021-07-30,37207,21036,Finance,West,1,445,16171
2021-11-19,38402,11610,Finance,South,3,335,26792
2022-02-28,12430,14250,Sales,North,8,468,-1820
2022-09-18,49828,11883,Sales,West,7,425,37945
2020-06-11,12936,16170,HR,South,8,149,-3234
2022-09-03,21864,26571,HR,North,6,288,-4707
2023-09-17,35115,21514,Sales,East,5,12,13601
2020-12-15,19307,13044,Finance,South,9,485,6263
2021-10-31,16709,13302,Finance,North,5,104,3407
2021-03-01,39854,7734,Sales,South,9,111,32120
2020-11-22,30707,6066,Finance,North,4,263,24641
2023-02-03,49384,9970,HR,East,5,435,39414
2020-09-11,45187,25172,Sales,East,1,173,20015
2020-12-23,11399,22701,HR,North,6,95,-11302
2021-03-19,34188,21668,Finance,West,3,321,12520
2020-04-22,24245,28350,Finance,East,2,444,-4105
2022-11-19,33371,12794,Operations,South,6,203,20577
2021-06-07,42286,9114,Marketing,East,1,45,33172
2021-11-19,31693,17834,Marketing,South,9,34,13859
2022-09-17,44303,21431,HR,East,5,211,22872
2020-02-15,31137,11138,Sales,East,7,395,19999
2023-04-09,25365,26245,Marketing,South,9,225,-880
2023-02-27,23450,24643,Finance,East,9,417,-1193
2022-01-26,14190,15270,IT,South,7,264,-1080
2023-10-08,33937,15498,Sales,South,4,301,18439
2023-05-11,17452,29226,HR,East,4,456,-11774
2023-06-03,13960,8415,Finance,East,7,226,5545
2023-01-08,49602,17595,Finance,South,8,104,32007
2023-08-26,40185,11450,IT,North,7,475,28735
2022-11-24,20564,18410,HR,East,4,221,2154
2021-07-17,15091,11164,Sales,West,4,334,3927
2020-06-09,40519,12787,Finance,East,8,418,27732
2022-04-19,13710,20924,Operations,North,9,301,-7214
2023-12-29,49395,17518,Finance,North,7,123,31877
2021-06-21,17988,25449,Operations,East,3,485,-7461
2020-08-12,45754,5081,Operations,East,1,449,40673
2023-09-02,38114,8005,Sales,West,5,457,30109
2023-12-08,33074,13408,Sales,East,6,436,19666
2020-04-04,31198,5334,IT,North,9,394,25864
2023-06-02,20509,16103,Finance,West,5,222,4406
2022-08-06,35180,13944,Sales,East,1,43,21236
2021-07-06,26560,16953,Sales,West,4,210,9607
2021-10-06,48938,15943,IT,West,2,337,32995
2020-03-06,45391,28452,IT,North,4,454,16939
2023-11-21,38731,8897,Finance,North,7,11,29834
2023-05-18,29162,29342,HR,South,9,216,-180
2021-10-26,35236,29485,Marketing,North,3,164,5751
2021-11-14,47133,9648,Finance,South,3,225,37485
2022-06-28,21379,14674,Marketing,North,4,225,6705
2022-04-16,14340,22166,HR,North,7,246,-7826
2021-07-24,14755,24970,Operations,South,6,146,-10215
2021-11-26,29905,8794,Finance,South,5,191,21111
2020-06-28,28259,20344,Sales,South,4,261,7915
2022-04-13,41255,17874,IT,West,8,287,23381
2022-12-27,46726,10597,Finance,South,4,16,36129
2023-09-14,44904,12050,IT,West,3,194,32854
2020-07-20,41614,10051,Operations,West,7,9,31563
2022-11-04,10506,22126,IT,South,2,2,-11620
2022-12-01,18599,9544,Operations,South,4,293,9055
2021-06-26,31774,17875,HR,South,8,84,13899
2022-09-08,18715,9355,Operations,North,4,443,9360
2022-02-12,31997,24992,Marketing,North,7,209,7005
2023-08-05,45818,24655,Finance,South,2,58,21163
2021-11-24,24783,23894,Operations,East,5,473,889
2023-06-21,41262,13285,Finance,South,4,339,27977
2021-09-03,33476,18308,HR,East,9,106,15168
2023-04-12,12397,27439,Operations,North,7,136,-15042
2020-08-31,37475,22759,HR,North,9,308,14716
2020-02-29,44077,7516,Marketing,East,7,331,36561
2020-04-13,49970,27622,Sales,North,2,461,22348
2021-10-12,17700,18155,HR,South,2,77,-455
2023-08-19,14718,21474,Sales,East,2,457,-6756
2022-10-07,37111,20403,HR,East,5,325,16708
2020-03-17,48718,6479,Operations,West,1,210,42239
2022-11-07,20233,22338,Sales,North,7,232,-2105
2023-04-22,24171,13214,HR,East,2,125,10957
2023-07-28,20726,17310,Finance,East,4,180,3416
2023-08-04,36768,24689,HR,East,9,462,12079
2021-11-28,27139,23105,Sales,North,8,290,4034
2022-08-03,10145,26836,Finance,East,2,214,-16691
2020-09-23,29958,7547,HR,East,4,432,22411
2022-02-19,36203,9923,Sales,South,4,97,26280
2021-08-31,31307,21572,Marketing,South,2,408,9735
2022-08-03,44626,21207,IT,West,2,249,23419
2023-10-12,47490,5459,Marketing,East,5,221,42031
2022-10-21,13598,7236,Sales,North,4,13,6362
2022-11-16,23583,25830,Operations,West,8,306,-2247
2021-07-01,27013,5580,Operations,West,4,91,21433
2020-06-08,46286,23545,IT,West,8,193,22741
2022-07-25,47120,19439,Sales,East,5,199,27681
2021-02-02,19096,9715,Finance,West,1,260,9381
2021-06-26,15555,15626,HR,North,9,64,-71
2020-05-06,42719,10897,Marketing,South,8,330,31822
2022-10-05,17997,24286,Finance,South,1,232,-6289
2022-08-05,20809,13664,Marketing,East,3,227,7145
2020-07-28,37365,22242,IT,North,3,167,15123
2020-05-29,35618,16181,IT,North,5,251,19437
2020-01-31,35964,23824,IT,North,7,447,12140
2021-09-03,19868,16898,Finance,East,1,186,2970
2020-10-28,31882,6712,Finance,North,1,249,25170
2022-08-20,30639,21899,IT,South,6,272,8740
2022-05-14,46963,12355,Finance,North,5,475,34608
2022-02-03,46589,15585,IT,North,3,340,31004
2021-11-13,39470,22759,Finance,East,3,446,16711
2020-09-13,15178,28068,IT,West,4,138,-12890
2022-07-28,20898,8669,HR,West,2,109,12229
2022-12-16,15566,19382,HR,East,9,318,-3816
2020-01-09,30353,20436,Marketing,East,4,417,9917
2022-10-25,48188,23774,Marketing,East,3,455,24414
2022-04-26,43375,8262,IT,East,7,426,35113
2023-02-11,15674,9638,Marketing,North,9,44,6036
2022-02-15,32272,7866,Finance,North,2,430,24406
2021-11-15,31716,29232,IT,West,6,342,2484
2022-01-01,33740,14251,HR,East,5,491,19489
2023-05-13,33170,13948,Operations,East,1,337,19222
2020-01-24,45162,24879,HR,North,7,201,20283
2021-05-07,21051,27878,Sales,East,1,378,-6827
2022-08-27,18070,5187,HR,South,9,104,12883
2023-11-30,39472,15573,Sales,North,4,458,23899
2020-04-12,44789,25962,Marketing,South,8,484,18827
2022-12-19,30982,29477,HR,North,1,479,1505
2023-01-14,41518,24098,Operations,North,5,415,17420
2022-02-05,29399,12408,Finance,North,3,389,16991
2022-10-19,37313,21679,HR,West,4,120,15634
2021-01-06,26110,8533,Finance,West,4,402,17577
2021-11-09,44816,9140,HR,North,8,390,35676
2021-08-18,32353,9042,HR,North,3,362,23311
2020-07-20,38530,25654,Finance,North,1,434,12876
2020-03-29,10893,24435,Finance,North,5,383,-13542
2021-03-12,38724,26849,IT,East,2,28,11875
2020-04-29,36885,12733,HR,East,6,107,24152
2020-06-04,23613,19676,HR,East,4,280,3937
2021-02-02,24316,11005,Operations,West,9,453,13311
2020-07-06,16087,10870,Finance,South,7,28,5217
2022-12-11,45701,8904,Finance,North,2,186,36797
2021-10-13,28665,20467,Sales,East,7,195,8198
2021-08-09,44148,16973,Sales,East,8,146,27175
2020-08-17,39622,19208,Finance,East,3,260,20414
2023-02-27,40298,7261,Operations,North,3,360,33037
2020-02-24,26867,18045,Marketing,North,2,177,8822
2020-09-27,23164,22804,HR,South,1,128,360
2023-01-28,30163,28077,Marketing,West,3,384,2086
2022-12-28,16101,19508,Operations,South,7,106,-3407
2023-08-15,47722,29680,Marketing,North,9,416,18042
2022-08-27,48721,21862,Sales,South,9,352,26859
2023-10-09,49048,26902,IT,East,6,383,22146
2023-03-21,43546,11577,Marketing,South,6,211,31969
2020-11-25,13475,11785,IT,East,5,349,1690
2020-04-25,14723,13884,Marketing,South,2,481,839
2020-11-18,24890,8038,Operations,East,7,322,16852
2021-07-16,33270,5193,IT,South,1,314,28077
2020-08-16,16713,21442,Marketing,West,6,11,-4729
2020-12-25,37853,23270,Operations,South,4,367,14583
2022-10-25,18601,16801,Finance,North,3,481,1800
2020-01-28,27443,25957,Sales,North,1,489,1486
2023-10-19,27984,26606,HR,East,6,360,1378
2023-06-08,22735,7580,Operations,North,7,321,15155
2023-11-19,28617,17879,Operations,East,1,384,10738
2022-05-18,36228,17245,Sales,West,1,490,18983
2023-07-18,23974,18633,IT,North,7,17,5341
2023-08-20,20623,26028,Marketing,North,6,370,-5405
2023-11-07,25395,16277,IT,East,7,336,9118
2020-01-28,16469,12623,Operations,West,8,66,3846
2022-01-13,35040,5220,Finance,West,8,374,29820
2023-05-07,13166,5875,Marketing,South,9,113,7291
2023-01-10,31637,16654,HR,East,9,132,14983
2023-01-16,12209,6196,HR,East,7,416,6013
2023-11-14,18747,24093,Marketing,West,9,71,-5346
2021-08-02,43067,24115,Operations,East,6,413,18952
2021-03-26,30250,21719,Finance,North,9,61,8531
2021-03-08,34931,13416,Sales,North,2,444,21515
2021-01-08,43331,28398,Finance,North,2,457,14933
2021-03-10,22201,19370,IT,East,6,314,2831
2023-04-25,41305,6247,Finance,South,3,483,35058
2023-11-14,27574,29564,Finance,South,2,244,-1990
2020-08-05,40859,25341,IT,West,8,309,15518
2023-02-05,20096,18250,Sales,East,7,5,1846
2022-08-05,20228,12111,Sales,West,8,370,8117
2020-12-14,19218,25973,HR,East,6,317,-6755
2022-02-26,34831,6886,Sales,South,9,21,27945
2020-01-26,28802,5310,Marketing,North,9,186,23492
2022-12-07,28947,15760,HR,East,2,209,13187
2022-05-08,29335,22988,Operations,South,5,231,6347
2021-01-04,39907,27043,HR,South,9,14,12864
2022-11-03,26653,25366,Finance,South,3,352,1287
2023-04-25,49387,29944,Finance,North,5,79,19443
2022-06-02,32031,8546,HR,South,8,469,23485
2020-10-05,19119,26225,IT,West,2,182,-7106
2020-12-06,14555,27558,Sales,South,6,78,-13003
2023-09-13,11042,10351,Finance,South,4,297,691
2021-08-29,48212,29401,Finance,East,6,272,18811
2022-11-14,14188,22381,Marketing,East,3,51,-8193
2021-06-12,23060,5496,Sales,East,6,257,17564
2021-03-01,20233,27069,Finance,South,7,296,-6836
2020-01-29,13088,22347,IT,South,3,18,-9259
2022-08-13,11646,15196,Finance,West,5,290,-3550
2020-11-18,23127,6198,Sales,North,8,218,16929
2020-11-08,42615,15537,Marketing,South,2,445,27078
2021-08-06,10487,10910,Sales,North,7,100,-423
2023-07-17,25453,10484,IT,South,1,149,14969
2022-01-31,44515,18397,Marketing,North,7,385,26118
2020-10-21,26911,5576,Sales,East,1,155,21335
2021-10-17,27551,24544,IT,South,4,435,3007
2022-02-24,26278,5053,IT,West,4,395,21225
2020-08-10,30856,20989,HR,North,5,376,9867
2020-03-15,21931,16624,Finance,East,2,102,5307
2020-04-11,32188,20835,Marketing,West,6,115,11353
2022-06-03,10483,5228,Marketing,East,6,270,5255
2020-06-21,10451,21190,Finance,South,8,92,-10739
2022-10-24,14069,17022,Sales,West,1,439,-2953
2021-01-29,23386,5984,HR,North,4,411,17402
2022-04-12,17207,17660,Marketing,North,2,406,-453
2022-09-30,47165,23851,IT,West,8,21,23314
2020-06-15,48439,15041,Marketing,North,4,120,33398
2020-10-26,28157,5531,HR,East,8,408,22626
2020-04-27,32006,18711,Finance,West,2,19,13295
2021-05-26,19190,16227,Operations,North,4,24,2963
2021-09-03,28449,13028,Finance,East,9,26,15421
2023-04-13,39678,21945,IT,North,5,153,17733
2020-06-07,24929,5089,Marketing,East,6,301,19840
2023-11-08,49100,10735,Finance,South,9,364,38365
2023-06-04,17913,8145,IT,East,9,413,9768
2022-11-27,19995,6292,Sales,North,7,202,13703
2021-04-07,36727,25494,IT,East,2,499,11233
2023-12-25,11946,28880,Marketing,North,7,139,-16934
2020-04-13,46183,12559,Sales,West,9,280,33624
2022-09-08,11394,8781,Sales,West,2,24,2613
2023-05-01,12421,25451,Sales,South,7,12,-13030
2020-09-06,30303,24889,Operations,East,7,135,5414
2022-11-02,29467,7391,Operations,South,3,424,22076
2021-07-20,34504,22602,Sales,West,6,81,11902
2021-08-19,20980,26539,Finance,East,8,355,-5559
2021-09-12,11844,18204,Finance,East,8,70,-6360
2021-07-08,44572,7252,Finance,South,3,204,37320
2023-11-12,28887,8891,Marketing,South,6,79,19996
2020-03-11,28277,14866,Sales,East,2,480,13411
2022-08-13,47112,22159,Finance,East,2,279,24953
2022-08-30,32975,10229,Sales,East,8,199,22746
2021-03-13,29449,29800,IT,South,5,379,-351
2022-12-03,29459,12553,Finance,North,5,294,16906
2023-07-19,11259,5063,IT,West,4,415,6196
2022-11-03,28604,6787,IT,West,4,285,21817
2023-10-26,23859,28475,Finance,South,8,428,-4616
2023-02-09,35362,26440,HR,East,3,156,8922
2023-11-03,37943,17042,IT,West,3,76,20901
2020-11-09,31319,13069,Finance,West,8,219,18250
2023-12-09,45215,16726,IT,West,3,324,28489
2021-04-29,45897,8915,Marketing,West,2,277,36982
2020-06-17,17697,19655,Operations,East,5,265,-1958
2022-06-06,33075,17644,Operations,South,3,49,15431
2022-03-13,41360,5092,Operations,East,6,98,36268
2020-09-02,38160,15934,HR,East,7,293,22226
2020-09-22,38735,6677,Sales,West,3,21,32058
2022-04-28,41293,26892,IT,West,9,444,14401
2020-08-30,13949,27114,Marketing,East,1,23,-13165
2023-08-16,20659,8864,HR,East,7,472,11795
2023-09-12,18010,26320,Operations,East,4,138,-8310
2021-06-13,36769,22785,HR,North,7,230,13984
2022-04-26,33823,22990,Marketing,West,9,326,10833
2022-09-30,26400,17148,Finance,South,9,405,9252
2020-12-07,49009,16263,HR,South,1,357,32746
2023-06-26,24787,22281,Operations,South,4,29,2506
2022-01-29,17906,20113,Sales,North,7,315,-2207
2023-11-04,23303,9587,Operations,North,6,424,13716
2022-03-08,11266,25097,Operations,South,9,21,-13831
2021-06-15,43246,24515,Operations,South,7,342,18731
2022-05-13,13977,22916,HR,South,3,99,-8939
2023-11-05,16068,27919,Marketing,East,7,63,-11851
2020-02-11,41227,15169,Operations,West,5,302,26058
2023-09-30,22740,28670,Finance,North,2,133,-5930
2021-08-21,32797,6798,HR,North,3,15,25999
2023-07-08,17791,29546,Marketing,East,6,105,-11755
2020-11-01,10485,18782,Sales,North,6,111,-8297
2022-03-19,40695,22735,Operations,South,7,339,17960
2022-05-11,47441,18408,IT,North,6,336,29033
2023-06-17,10337,15030,HR,East,9,424,-4693
2021-11-09,35436,15752,Finance,West,5,111,19684
2023-08-29,25092,12051,Sales,South,5,363,13041
2021-12-31,44771,28242,Sales,North,8,343,16529
2021-03-16,11471,14855,Sales,South,8,4,-3384
2022-07-21,37696,15589,HR,West,1,469,22107
2022-06-21,16489,16395,Marketing,North,3,152,94
2020-05-12,17856,17833,IT,South,6,42,23
2021-12-19,38611,5598,Finance,East,6,375,33013
2020-02-20,19365,19367,Marketing,East,1,26,-2
2021-09-09,44373,23428,Operations,West,2,362,20945
2021-01-26,15664,21642,IT,West,7,194,-5978
2021-11-26,33323,25955,Marketing,West,1,360,7368
2021-06-06,36455,13003,Operations,North,5,8,23452
2021-05-22,15379,28352,IT,West,1,73,-12973
2020-12-19,12124,15097,HR,North,6,450,-2973
2022-05-16,41536,18207,Finance,South,7,78,23329
2022-08-30,14991,27560,Finance,East,8,148,-12569
2023-11-19,16794,28426,Operations,South,3,322,-11632
2022-08-13,39218,29963,Marketing,East,3,68,9255
2020-04-05,41113,16824,IT,West,1,355,24289
2020-04-15,46074,5797,Operations,South,3,183,40277
2021-11-08,37977,15695,Operations,South,5,334,22282
2021-05-27,38359,10713,HR,West,6,85,27646
2023-06-19,28043,12311,Operations,South,3,496,15732
2022-05-05,32523,25404,IT,North,4,79,7119
2022-02-28,19070,10911,Sales,East,5,39,8159
2021-05-29,17199,8954,IT,West,5,306,8245
2022-06-16,28703,14819,IT,North,9,20,13884
2022-12-20,29267,9312,HR,North,8,70,19955
2023-12-10,24133,13980,HR,West,1,156,10153
2022-10-04,38571,27023,Finance,South,2,117,11548
2023-08-10,36991,27563,Finance,East,5,368,9428
2022-01-06,21579,28163,Operations,North,3,427,-6584
2020-10-28,43355,23440,Finance,South,7,450,19915
2023-04-08,29003,20828,HR,West,6,28,8175
2021-10-07,31871,18952,Operations,West,2,375,12919
2022-11-30,16223,12102,Sales,East,8,98,4121
2020-08-18,24197,28028,Marketing,West,5,462,-3831
2023-12-03,19387,17660,HR,East,6,329,1727
2022-01-07,47121,20427,HR,West,8,151,26694
2022-09-23,36902,27169,Sales,West,6,364,9733
2020-10-23,24839,6447,HR,North,3,419,18392
2021-03-30,45373,21898,Finance,South,7,22,23475
2022-12-16,45306,17651,Finance,North,4,261,27655
2022-07-30,23896,23297,Finance,East,6,60,599
2020-08-27,26198,20112,Sales,North,6,425,6086
2023-04-14,44524,6951,Operations,West,5,413,37573
2022-12-22,38651,26954,HR,West,1,163,11697
2021-07-04,42636,18827,HR,South,8,114,23809
2020-05-17,44128,13965,Finance,East,2,354,30163
2021-03-29,37144,5328,Operations,West,4,196,31816
2023-06-03,28757,13985,HR,South,3,45,14772
2021-03-18,43963,27897,IT,South,6,113,16066
2023-05-14,28515,17884,Sales,West,1,393,10631
2020-01-27,32027,10973,Marketing,West,9,179,21054
2021-04-01,23792,22794,IT,East,5,270,998
2021-11-25,25777,12714,Marketing,South,5,493,13063
2021-12-10,29794,6137,IT,South,4,325,23657
2022-04-28,42544,26050,IT,South,4,370,16494
2022-08-06,28751,26541,IT,East,1,56,2210
2020-04-16,41023,22952,Sales,South,9,367,18071
2021-03-19,29727,9472,Marketing,North,9,347,20255
2020-02-05,33665,28950,Operations,North,4,267,4715
2021-08-19,41126,8274,Operations,South,4,414,32852
2020-06-03,29481,8273,Finance,North,7,115,21208
2023-04-07,35836,27627,HR,North,4,357,8209
2022-03-06,44101,24853,Sales,East,1,167,19248
2020-09-28,33549,27316,Finance,South,9,354,6233
2023-12-14,13336,20151,Finance,East,2,115,-6815
2023-04-22,18157,15155,Sales,South,5,408,3002
2023-06-14,46155,27948,Sales,West,4,80,18207
2022-09-07,47481,10362,IT,North,8,314,37119
2020-05-01,41567,9636,Sales,East,6,286,31931
2023-12-11,47869,10346,Operations,East,7,408,37523
2023-10-30,12431,22620,Sales,West,2,323,-10189
2023-09-11,43784,15938,IT,West,4,29,27846
2020-05-29,27025,9208,Marketing,North,4,42,17817
2021-12-07,30446,9468,Finance,North,2,460,20978
2022-09-21,18507,7346,Sales,South,4,119,11161
2020-06-01,43208,18984,Finance,South,9,62,24224
2022-11-06,27522,6042,Marketing,West,8,155,21480
2021-07-04,35490,18063,HR,North,1,285,17427
2022-04-24,48011,26150,IT,North,8,450,21861
2023-10-03,45071,25490,Finance,West,9,441,19581
2023-05-10,40413,13199,Sales,West,8,189,27214
2023-12-17,24040,28704,HR,East,1,285,-4664
2020-10-06,48718,8731,HR,West,8,104,39987
2021-02-25,17046,14765,Marketing,East,5,57,2281
2022-09-19,49374,12302,Finance,South,9,457,37072
2022-03-14,46189,26876,Finance,West,9,311,19313
2020-12-20,28462,21844,Operations,West,6,372,6618
2021-01-12,48871,21294,Operations,West,3,172,27577
2023-02-21,30534,7302,Operations,East,7,384,23232
2020-03-20,44968,24017,Finance,West,3,156,20951
2022-09-14,30935,14543,Finance,West,7,165,16392
2020-08-20,19009,5361,Operations,North,8,407,13648
2020-06-02,11946,10493,IT,North,5,333,1453
2022-06-25,46724,28530,Sales,North,5,69,18194
2023-12-03,13325,22171,Sales,West,4,480,-8846
2022-11-20,18699,21592,IT,North,3,476,-2893
2021-01-05,13745,13458,Marketing,South,8,58,287
2020-11-18,40794,10092,Sales,North,6,207,30702
2020-11-27,34544,21937,Finance,West,6,472,12607
2020-08-30,31198,13025,HR,North,2,416,18173
2021-03-05,23489,18817,Finance,North,4,85,4672
2023-04-20,32474,14779,Sales,North,5,325,17695
2022-03-19,28420,9516,IT,South,5,101,18904
2021-01-10,12677,11451,Marketing,South,3,292,1226
2020-03-21,44512,19530,Sales,East,5,251,24982
2021-02-23,21175,14310,IT,West,5,220,6865
2021-04-11,11177,6513,HR,South,2,160,4664
2023-12-22,10761,28809,Operations,South,5,187,-18048
2022-12-16,47546,18336,HR,South,3,384,29210
2023-09-07,16458,26735,HR,West,3,444,-10277
2023-07-13,30110,16595,Marketing,East,5,87,13515
2023-06-04,38253,11749,Sales,West,9,464,26504
2022-04-08,28317,12005,Operations,North,2,498,16312
2022-03-14,38433,29796,IT,East,9,330,8637
2022-12-13,17179,23728,Operations,North,3,349,-6549
2022-09-04,24849,28538,Sales,South,7,155,-3689
2020-01-04,14444,23355,Marketing,West,1,355,-8911
2023-08-26,12964,9438,Sales,North,1,490,3526
2021-08-25,22811,17880,IT,East,8,493,4931
2023-01-17,20067,26708,Operations,North,9,280,-6641
2020-11-15,49992,17256,HR,North,3,343,32736
2023-10-30,20472,15176,Sales,South,6,323,5296
2021-05-15,25126,21359,Finance,North,3,164,3767
2023-06-11,13101,19412,Marketing,North,6,493,-6311
2023-09-22,36990,27053,Marketing,South,7,398,9937
2021-07-24,46665,19287,Operations,East,5,68,27378
2020-07-03,13678,26545,HR,South,3,428,-12867
2021-07-09,44611,22589,IT,North,8,432,22022
2023-04-18,40729,18044,HR,West,5,362,22685
2023-01-04,39035,23239,Operations,South,1,375,15796
2022-06-11,25958,23383,HR,South,9,288,2575
2023-07-19,34250,7435,Operations,North,3,212,26815
2020-02-24,17083,16166,HR,West,2,120,917
2022-05-12,31756,28164,Sales,East,3,401,3592
2020-03-17,11466,8098,Marketing,West,7,477,3368
2020-10-22,10339,8386,Operations,South,8,185,1953
2023-05-27,31103,10440,Operations,West,2,423,20663
2023-07-24,27088,17735,Marketing,East,7,416,9353
2022-01-15,13724,15008,Finance,West,5,452,-1284
2023-07-13,31643,11436,Finance,West,9,216,20207
2022-06-18,36044,23161,IT,West,7,492,12883
2020-02-12,20334,12403,Operations,South,1,490,7931
2023-10-16,43320,28242,Sales,North,1,130,15078
2023-06-05,46259,15696,HR,North,6,78,30563
2020-08-14,10789,7939,Sales,West,9,488,2850
2022-12-22,43941,22222,Operations,South,1,170,21719
2020-06-19,10552,27109,IT,South,3,38,-16557
2022-08-20,29806,26143,Operations,South,5,55,3663
2022-01-31,46979,26244,IT,North,4,439,20735
2022-04-29,18823,8138,Marketing,South,1,290,10685
2020-11-02,41980,21559,HR,West,4,46,20421
2021-07-21,10860,25989,Sales,North,4,171,-15129
2022-09-18,10290,8162,IT,South,4,130,2128
2020-02-03,24344,7752,Sales,West,3,164,16592
2022-04-06,15870,17889,Marketing,North,7,70,-2019
2020-05-09,43397,5837,Operations,South,1,292,37560
2023-11-18,49775,17043,IT,East,2,406,32732
2023-03-20,26186,20797,HR,West,1,69,5389
2021-10-16,48711,19386,IT,East,4,422,29325
2021-09-21,42265,29229,Finance,North,5,105,13036
2023-11-08,31016,7733,Operations,South,5,54,23283
2022-11-06,14080,17002,Operations,West,2,406,-2922
2021-08-16,22972,19601,HR,West,3,368,3371
2022-11-03,11760,29072,HR,West,4,459,-17312
2020-03-21,21274,10206,Marketing,East,6,363,11068
2023-05-15,47476,7653,Sales,South,6,248,39823
2020-07-22,33304,27524,IT,South,2,415,5780
2023-11-03,22166,28603,Marketing,South,2,309,-6437
2020-01-23,13398,24733,Sales,East,9,373,-11335
2021-09-05,40625,8310,Marketing,North,2,106,32315
2023-03-31,20515,9680,Finance,East,2,349,10835
2020-05-23,24705,23770,HR,North,3,315,935
2020-04-13,46329,10191,HR,East,9,97,36138
2023-11-06,20607,21757,Operations,South,6,342,-1150
2023-12-11,40006,9675,IT,South,6,433,30331
2020-11-19,23018,17804,IT,South,5,27,5214
2023-04-09,19816,21210,IT,East,7,72,-1394
2021-07-29,30494,6261,Marketing,West,4,378,24233
2020-09-30,31237,12633,Marketing,East,3,496,18604
2021-03-27,16831,13312,IT,North,7,185,3519
2022-05-30,40541,10532,Operations,East,1,134,30009
2020-05-04,13447,27226,Sales,North,6,174,-13779
2023-11-07,15584,25229,Finance,East,2,281,-9645
2020-11-12,37156,7884,Marketing,West,2,98,29272
2020-04-16,46559,15809,IT,West,8,393,30750
2022-06-25,31465,25522,HR,South,3,64,5943
2021-03-05,27217,10623,Marketing,West,9,484,16594
2021-12-04,20190,16460,Sales,East,4,415,3730
2023-09-22,15335,15234,Marketing,West,6,403,101
2022-08-29,16260,23503,Sales,South,1,113,-7243
2020-12-27,35778,29100,Sales,East,3,65,6678
2022-03-06,25605,21874,Marketing,North,4,216,3731
2021-03-07,28559,19137,Sales,East,5,354,9422
2021-11-05,30557,8045,Marketing,South,1,401,22512
2022-05-08,45556,5382,Marketing,West,4,290,40174
2023-11-30,34917,22188,Operations,West,5,483,12729
2022-10-10,35937,10585,HR,East,4,420,25352
2023-11-01,41538,14369,Finance,North,7,397,27169
2023-03-21,16721,7217,Sales,North,8,315,9504
2023-09-07,30575,14487,Marketing,North,8,89,16088
2023-05-22,17312,28661,Sales,North,3,247,-11349
2021-07-29,14616,17718,Marketing,East,5,332,-3102
2022-12-24,43763,27978,Finance,West,8,149,15785
2022-06-11,43124,28170,Marketing,North,7,357,14954
2020-09-26,34761,20115,Marketing,East,9,366,14646
2023-01-28,11693,27550,HR,East,7,486,-15857
2023-02-02,12590,23798,Sales,East,2,449,-11208
2023-02-28,40870,5650,HR,North,4,240,35220
2023-11-13,19534,13169,HR,North,8,6,6365
2023-09-06,17921,26299,HR,East,9,237,-8378
2021-03-13,11691,21312,HR,East,7,365,-9621
2022-11-08,12904,15943,Operations,East,5,267,-3039
2020-08-12,49705,8198,Sales,West,1,336,41507
2022-09-16,40956,22325,Sales,West,9,406,18631
2021-04-04,28764,13732,Marketing,South,6,238,15032
2021-01-28,18208,10805,Sales,South,2,139,7403
2023-06-03,25783,25111,Finance,North,2,165,672
2022-06-30,18515,23913,HR,West,1,282,-5398
2023-10-15,12070,6202,IT,South,4,185,5868
2023-12-24,27314,26348,Sales,East,2,154,966
2020-01-15,23771,22034,IT,East,9,106,1737
2021-07-13,41240,8006,Finance,North,2,149,33234
2022-09-30,27828,24288,Operations,North,9,185,3540
2021-02-17,34978,13505,Marketing,South,1,410,21473
2023-10-10,30936,25498,Marketing,East,7,271,5438
2022-09-25,36082,14375,Marketing,North,6,359,21707
2023-05-04,27905,18105,Operations,North,6,191,9800
2020-04-24,13098,21505,HR,West,2,163,-8407
2023-12-11,37020,11603,IT,South,1,395,25417
2023-10-07,28952,29744,Sales,North,8,201,-792
2022-09-02,20985,8682,HR,South,8,106,12303
2023-01-03,18283,18460,Marketing,East,2,215,-177
2020-02-05,47708,26108,Marketing,South,4,324,21600
2020-08-29,14762,25505,HR,North,4,478,-10743
2020-03-03,44521,18559,IT,West,2,220,25962
2021-10-27,15054,11864,HR,South,9,345,3190
2021-05-23,23276,28778,Operations,South,4,470,-5502
2020-07-06,15781,19234,Marketing,East,4,217,-3453
2022-01-04,26471,16889,IT,West,4,474,9582
2020-04-02,28025,6729,Sales,South,5,434,21296
2020-01-05,45730,16747,Marketing,West,8,29,28983
2023-04-04,15413,27336,HR,North,4,238,-11923
2020-01-25,17420,26513,IT,West,3,64,-9093
2021-05-22,49678,22502,Marketing,North,1,425,27176
2020-04-07,36527,7168,Sales,East,2,96,29359
2023-07-15,22029,17413,Sales,East,4,154,4616
2021-10-23,46525,19884,Finance,East,9,28,26641
2023-11-17,47564,17973,HR,North,1,340,29591
2023-08-01,46060,12668,Operations,South,6,176,33392
2021-11-14,13832,18260,HR,North,6,251,-4428
2023-02-06,12611,16308,IT,West,3,194,-3697
2020-01-27,18353,22434,HR,West,9,279,-4081
2020-02-24,37589,13896,IT,North,3,39,23693
2023-03-02,35421,11640,Finance,East,1,69,23781
2022-12-11,21068,24283,Finance,East,2,277,-3215
2022-02-19,13346,24591,Finance,West,4,120,-11245
2020-10-24,46822,18919,Operations,West,4,86,27903
2023-11-23,14200,12674,Finance,South,2,177,1526
2022-11-07,18527,25216,HR,South,6,459,-6689
2022-03-28,20535,23392,Sales,South,6,94,-2857
2022-05-04,27944,9721,IT,West,3,92,18223
2021-07-12,14164,6066,IT,South,1,420,8098
2023-06-23,40022,15138,Sales,West,9,81,24884
2021-05-17,22438,29671,HR,West,4,341,-7233
2023-01-17,33104,6918,Operations,North,9,421,26186
2020-07-21,14852,14457,Marketing,South,5,228,395
2022-08-03,16713,15726,HR,North,7,383,987
2020-08-27,13183,19282,Finance,North,3,473,-6099
2021-05-04,41354,29815,HR,South,3,88,11539
2022-11-02,18032,22711,IT,West,8,350,-4679
2021-10-10,24275,27594,IT,West,1,128,-3319
2023-08-31,28793,12448,Operations,West,8,298,16345
2021-11-15,47066,28743,Finance,South,8,190,18323
2023-05-06,28918,6142,Operations,West,3,355,22776
2020-08-30,15599,24607,Operations,North,1,469,-9008
2021-05-21,42771,25232,Sales,East,9,134,17539
2022-12-02,23440,6415,Marketing,South,4,469,17025
2023-09-15,21289,11374,Marketing,East,7,136,9915
2023-12-23,15161,5760,Finance,North,9,325,9401
2021-09-04,10964,8642,Operations,East,3,40,2322
2020-06-10,25942,22936,IT,North,5,138,3006
2021-10-17,48369,22246,Marketing,East,3,287,26123
2022-08-16,24184,14347,HR,East,5,256,9837
2021-09-12,12947,29932,Sales,West,2,286,-16985
2023-12-29,16238,28593,IT,East,4,435,-12355
2023-06-10,23156,6328,Sales,North,2,85,16828
2020-04-20,12411,22413,HR,North,3,420,-10002
2022-07-22,25674,23760,Marketing,North,5,317,1914
2023-06-09,18308,24625,Sales,South,9,27,-6317
2022-01-19,12924,17063,Finance,North,3,230,-4139
2021-12-09,45605,8140,Sales,South,6,291,37465
2020-09-29,10576,22265,Sales,North,4,316,-11689
2022-03-17,24641,13730,HR,South,4,288,10911
2020-02-10,18963,19057,IT,East,5,346,-94
2021-07-13,34291,8557,IT,East,7,132,25734
2021-04-10,42728,18211,HR,North,4,91,24517
2023-01-05,28789,28447,Sales,South,8,356,342
2021-05-04,49651,19386,Sales,West,9,229,30265
2020-04-26,37899,23580,Operations,West,9,27,14319
2021-03-09,25658,23334,Finance,West,9,303,2324
2022-11-08,48907,14802,Marketing,East,2,496,34105
2022-09-20,24184,27321,Marketing,East,3,390,-3137
2020-07-14,41747,8163,IT,South,5,466,33584
2021-09-10,22965,9463,HR,North,1,282,13502
2021-02-28,20493,9007,Sales,East,4,492,11486
2023-11-18,36178,9675,Finance,North,5,280,26503
2023-07-31,43887,19058,Marketing,West,9,199,24829
2020-02-03,12214,21233,HR,West,8,375,-9019
2020-10-21,18000,9751,HR,North,1,300,8249
2022-10-03,18065,11219,Sales,South,3,398,6846
2023-06-28,11085,20445,Finance,West,3,397,-9360
2020-12-04,13532,13418,HR,South,6,154,114
2021-09-09,27622,28914,Marketing,West,4,299,-1292
2020-06-28,14834,12735,Operations,East,4,43,2099
2021-09-13,30197,13783,Marketing,West,1,322,16414
2023-06-05,22008,23459,Finance,South,4,110,-1451
2021-09-10,22962,19456,Operations,East,1,111,3506
2021-10-04,18012,29156,HR,West,5,471,-11144
2020-01-23,30166,18140,Marketing,East,3,412,12026
2023-09-12,28628,15863,Sales,East,5,1,12765
2023-03-23,19849,20225,Finance,West,3,480,-376
2021-09-10,23767,23406,HR,North,5,140,361
2023-03-15,25111,7078,Sales,North,4,366,18033
2020-09-08,49989,17142,Operations,South,9,178,32847
2020-10-28,43891,17073,IT,South,6,437,26818
2022-12-29,31565,28778,IT,West,2,60,2787
2023-01-21,45011,28397,Operations,East,1,183,16614
2020-06-11,12589,8321,IT,East,1,419,4268
2023-01-09,19749,17337,Finance,North,1,445,2412
2022-12-22,32683,20061,HR,North,9,282,12622
2021-09-03,14501,11011,HR,East,5,415,3490
2023-12-30,33423,23820,Finance,East,4,313,9603
2022-12-07,29157,12087,Marketing,South,5,396,17070
2021-03-20,29169,14996,HR,East,9,221,14173
2020-03-14,33324,24743,IT,East,3,389,8581
2022-04-05,11706,6730,Finance,West,3,227,4976
2021-06-25,38219,19077,Sales,East,2,391,19142
2020-06-05,11612,25046,Marketing,North,8,144,-13434
2023-07-13,26838,26494,Sales,North,7,224,344
2020-09-12,47065,11618,IT,South,2,52,35447
2022-11-28,40427,11899,Sales,South,4,81,28528
2022-12-14,25546,6029,IT,West,7,149,19517
2022-11-17,19045,20128,HR,South,1,27,-1083
2022-07-25,35299,5411,Marketing,East,1,232,29888
2020-04-27,11391,6981,Operations,East,8,111,4410
2021-01-04,42667,14539,IT,West,6,372,28128
2020-07-27,25948,24854,Finance,North,2,79,1094
2021-08-09,35118,6305,Finance,East,1,279,28813
2022-04-28,48193,17478,HR,East,3,127,30715
2020-11-11,24157,26064,Finance,West,4,456,-1907
2023-11-17,27021,18246,Sales,North,5,281,8775
2021-03-19,18356,9595,HR,South,3,395,8761
2023-07-06,45573,22199,Finance,East,5,319,23374
2023-05-06,11223,16697,Sales,North,7,441,-5474
2021-09-19,46110,20422,Sales,West,9,341,25688
2021-03-20,34626,14668,Sales,West,5,182,19958
2021-07-23,40917,10612,Finance,North,4,119,30305
2021-08-04,31526,7037,Sales,West,9,266,24489
2021-08-27,18856,14522,Marketing,South,8,178,4334
2022-01-10,48829,26259,Finance,North,5,201,22570
2022-06-26,23532,16998,Sales,South,9,368,6534
2021-10-10,30745,12086,Marketing,West,9,385,18659
2020-10-31,30336,6149,Operations,South,1,470,24187
2020-12-04,40796,27792,Marketing,South,6,70,13004
2021-06-12,37167,21390,Finance,South,5,158,15777
2020-02-23,10880,6436,Finance,South,6,311,4444
2023-02-09,26818,8250,Sales,North,3,98,18568
2021-11-14,48892,29047,Finance,West,3,205,19845
2021-02-22,34488,22078,Operations,West,5,86,12410
2020-10-31,47952,26471,HR,East,7,390,21481
2020-03-25,28368,19263,Marketing,South,4,361,9105
2020-09-08,39028,24683,HR,South,6,494,14345
2020-05-05,23223,9843,Operations,East,5,280,13380
2021-09-01,41395,17433,Marketing,East,2,85,23962
2023-11-29,40261,29121,Sales,South,1,359,11140
2020-10-30,19984,16559,Marketing,West,6,215,3425
2022-11-17,12798,9952,Sales,East,5,133,2846
2022-04-27,17603,26431,IT,South,9,391,-8828
2023-07-13,21704,12842,Marketing,West,7,387,8862
2022-12-11,44261,5025,Marketing,North,1,247,39236
2021-10-16,25707,25931,HR,East,6,141,-224
2021-10-05,28009,7153,HR,East,7,438,20856
2022-05-07,28231,13019,Operations,West,3,447,15212
2021-05-25,13246,24873,Sales,North,9,76,-11627
2020-07-25,39825,13523,Finance,West,2,390,26302
2021-07-27,25925,10161,HR,East,1,98,15764
2022-05-24,11316,22028,Operations,North,9,463,-10712
2021-05-25,28334,6852,Sales,South,7,303,21482
2020-07-19,41072,12723,Sales,East,1,466,28349
2022-04-02,12026,25514,Sales,West,4,55,-13488
2023-07-31,11547,20706,IT,West,3,305,-9159
2023-10-12,25289,15623,Sales,West,7,441,9666
2022-12-06,46546,24968,Operations,West,5,259,21578
2022-10-16,49279,8809,Sales,West,9,22,40470
2020-05-16,32169,6311,Finance,East,3,35,25858
2020-05-09,30107,23278,Finance,North,6,28,6829
2023-05-03,44291,16198,Sales,West,2,489,28093
2022-10-14,37279,11238,Operations,West,3,170,26041
2023-10-19,28356,25684,Marketing,South,4,140,2672
2021-03-07,40043,12788,Sales,South,6,129,27255
2022-12-28,39966,11977,Operations,North,1,100,27989
2021-06-23,22795,27557,HR,East,6,478,-4762
2020-11-30,27000,11409,Operations,East,4,373,15591
2021-06-09,30899,7070,IT,North,8,247,23829
2021-07-11,31575,7656,HR,North,9,23,23919
2022-06-27,32158,9134,Finance,North,8,357,23024
2022-11-05,29005,25652,Finance,West,8,284,3353
2021-05-24,28477,27394,Marketing,East,2,113,1083
2020-07-27,29560,8484,Marketing,North,2,373,21076
2023-03-27,35708,21797,Operations,South,6,197,13911
2023-09-22,29954,29225,Operations,West,5,164,729
2023-06-18,40635,15854,Sales,West,6,381,24781
2020-02-27,28530,19544,Sales,West,9,310,8986
2022-03-26,10705,17309,Finance,West,7,431,-6604
2023-08-21,46580,11148,IT,North,5,56,35432
2023-09-30,37046,25693,Sales,West,7,10,11353
2022-11-03,30152,10791,Finance,South,8,133,19361
2023-10-14,41855,22303,Operations,South,1,398,19552
2021-01-11,12319,22290,Operations,North,7,152,-9971
2020-08-30,18163,24594,Sales,West,4,191,-6431
2022-09-19,31605,24103,IT,South,5,284,7502
2023-03-14,10209,16858,Finance,East,2,277,-6649
2022-06-09,14834,20002,Operations,West,5,493,-5168
2021-02-18,41512,9895,Finance,North,9,243,31617
2021-01-28,22446,15556,IT,East,1,488,6890
2021-12-29,13962,22176,Operations,West,3,332,-8214
2020-12-23,23028,14919,Finance,East,4,276,8109
2023-03-27,31903,16419,IT,West,9,190,15484
2021-11-04,21717,26927,IT,West,2,115,-5210
2020-01-18,47562,17378,IT,South,7,352,30184
2021-12-28,40545,8725,Sales,East,9,307,31820
2021-07-14,45212,29575,Marketing,East,4,358,15637
2023-10-02,45375,26545,Finance,North,5,296,18830
2022-12-17,30320,16558,IT,North,4,234,13762
2020-06-03,29301,18057,Finance,East,7,341,11244
2021-05-01,28181,6360,IT,South,8,81,21821
2020-05-30,19168,7048,Finance,South,8,193,12120
2023-10-14,12573,11252,Operations,West,3,371,1321
2021-01-02,28973,16167,Finance,North,2,364,12806
2022-12-06,46051,27482,Marketing,North,6,412,18569
2020-07-25,30801,24580,Operations,North,1,438,6221
2021-03-25,38644,5205,Operations,West,9,258,33439
2022-07-12,37523,16678,IT,South,7,465,20845
2021-11-27,43481,20185,HR,North,8,231,23296
2021-07-23,28807,24699,Marketing,West,7,14,4108
2020-05-22,11890,28117,Operations,East,5,14,-16227
2023-11-24,29951,13814,HR,South,5,44,16137
2023-01-25,15375,23061,HR,East,7,496,-7686
2022-12-06,41305,16479,Operations,North,7,210,24826
2020-07-09,25579,16204,IT,West,2,40,9375
2020-05-19,19870,18839,Sales,South,2,34,1031
2021-09-06,28531,24396,Operations,North,7,235,4135
2023-06-08,19109,16829,IT,South,5,321,2280
2023-09-25,36842,15892,Marketing,West,2,234,20950
2022-07-13,20716,28931,IT,West,1,274,-8215
2022-12-08,28190,6871,HR,North,9,368,21319
2021-09-15,46819,29654,Marketing,South,8,290,17165
2023-09-01,42433,27942,Marketing,West,2,343,14491
2023-09-07,35204,26118,Sales,South,2,433,9086
2020-03-27,46530,27173,Sales,South,3,336,19357
2020-10-08,36384,11934,Operations,East,4,467,24450
2022-02-02,20087,24612,IT,North,9,229,-4525
2023-01-02,22122,7335,Operations,North,6,380,14787
2021-03-28,40898,6725,Sales,South,3,439,34173
2020-02-16,25841,27121,HR,East,8,318,-1280
2023-01-24,35582,14306,Sales,South,6,128,21276
2022-07-26,20042,10985,IT,North,8,326,9057
2020-01-31,36505,12216,HR,North,2,408,24289
2021-06-17,33294,21544,Operations,South,8,209,11750
2020-01-17,16173,6425,Operations,South,5,304,9748
2023-05-20,28516,6733,Sales,South,4,80,21783
2023-06-12,16932,17607,Sales,North,3,295,-675
2021-01-26,27909,15603,Finance,South,9,176,12306
2022-10-03,40241,17152,Operations,South,7,233,23089
2020-12-19,26712,20801,Operations,West,7,326,5911
2020-10-31,12657,23906,Marketing,North,6,336,-11249
2021-05-23,39105,28550,IT,South,9,265,10555
2021-12-12,40382,21985,Marketing,East,3,285,18397
2023-11-19,32356,14747,Marketing,North,1,452,17609
2023-12-25,29589,26068,Operations,South,7,444,3521
2021-11-15,49601,18531,Finance,South,9,410,31070
2022-02-24,33916,18985,IT,West,6,118,14931
2022-05-06,44366,6520,Operations,West,2,166,37846
2020-06-25,13851,7390,Marketing,North,8,318,6461
2023-11-30,37048,6117,Marketing,West,9,410,30931
2020-10-27,17582,12300,Operations,West,8,142,5282
2021-03-20,14607,14716,Sales,North,9,483,-109
2023-02-24,15507,17459,Sales,East,1,247,-1952
2023-10-04,15934,26105,Operations,South,3,177,-10171
2020-01-21,31952,11141,HR,South,3,299,20811
2022-10-12,14659,24464,HR,West,9,344,-9805
2021-12-11,14398,12939,Sales,South,3,264,1459
2021-12-01,16242,9777,IT,West,1,168,6465
2023-12-14,38620,28649,Finance,North,3,25,9971
2020-05-31,35905,16432,Marketing,North,2,191,19473
2023-03-29,20796,19271,IT,North,9,388,1525
2022-05-08,49379,8801,Sales,South,1,15,40578
2020-04-05,49480,12057,Operations,West,2,16,37423
2023-10-07,47275,12510,HR,West,1,310,34765
2023-01-03,23937,13099,Sales,South,9,127,10838
2022-05-27,41531,20193,IT,North,7,267,21338
2021-10-01,29569,27465,IT,East,1,28,2104
2023-10-14,22343,25011,Finance,West,6,263,-2668
2023-03-02,21533,21132,Sales,West,5,370,401
2021-02-03,41132,25764,Marketing,South,5,384,15368
2023-03-08,41356,26763,IT,East,4,294,14593
2020-09-02,25438,23926,Marketing,North,3,152,1512
2023-08-07,36366,9450,Marketing,West,8,479,26916
2020-04-21,23968,19549,Operations,South,7,68,4419
2023-04-08,27490,11960,Sales,East,5,37,15530
2023-06-17,29173,21583,Sales,South,9,376,7590
2023-09-22,20376,11996,Marketing,East,7,35,8380
2023-03-07,35114,23567,Operations,South,2,134,11547
2023-06-13,31168,19201,IT,East,7,366,11967
2022-03-04,10718,10043,IT,West,7,161,675
2022-10-23,49844,25420,Sales,East,4,372,24424
2020-04-25,46763,26396,Marketing,North,8,224,20367
2023-02-28,10305,12834,Operations,West,4,110,-2529
2022-07-22,31814,24877,Operations,North,7,102,6937
2023-11-25,40711,25356,IT,West,4,355,15355
2023-05-09,24177,14556,IT,East,8,465,9621
2020-10-18,34570,6852,HR,West,3,182,27718
2020-12-07,45364,21263,HR,South,2,480,24101
2022-10-11,28819,17629,Marketing,East,6,398,11190
2023-05-24,41391,29963,HR,South,7,147,11428
2021-08-07,25788,6662,Operations,South,7,216,19126
2023-10-21,19896,19734,HR,South,6,487,162
2023-12-12,30559,12589,Sales,South,8,139,17970
2020-01-27,33565,15650,Sales,North,6,327,17915
2021-03-30,30926,21596,Finance,East,6,429,9330
2022-07-06,23376,9655,IT,South,3,188,13721
2021-08-02,31875,13749,IT,North,2,88,18126
2020-01-14,22857,15797,Marketing,West,7,247,7060
2020-04-07,11283,24503,Sales,South,6,186,-13220
2020-10-05,24920,11645,Finance,South,1,88,13275
2021-05-04,10247,16895,Marketing,North,2,334,-6648
2022-09-11,40846,24075,Marketing,West,2,152,16771
2022-08-18,16642,6994,HR,West,1,267,9648
2021-09-15,27365,19866,IT,North,3,200,7499
2020-07-25,47131,26432,Marketing,South,5,383,20699
2023-06-10,27949,20122,Marketing,East,4,428,7827
2021-08-19,43503,21858,IT,North,2,335,21645
2021-11-25,20851,13233,IT,East,8,490,7618
2023-06-16,24406,15843,Sales,South,9,246,8563
2020-09-06,24928,8992,IT,South,8,450,15936
2022-01-09,26832,9823,HR,West,7,216,17009
2020-11-01,17534,8517,Sales,South,2,429,9017
2023-06-13,11835,7268,Finance,West,6,74,4567
2023-08-07,14715,21006,Marketing,West,4,160,-6291
2022-11-28,43381,22323,HR,South,5,255,21058
2022-09-24,32618,9438,HR,West,9,17,23180
2021-12-18,10876,16501,Sales,South,9,438,-5625
2020-07-01,19325,11298,Marketing,West,4,138,8027
2021-10-06,39446,24369,Sales,West,8,470,15077
2020-01-30,43439,18128,Operations,South,5,6,25311
2023-11-12,11630,16319,Operations,East,9,219,-4689
2022-02-05,43128,19722,Sales,North,2,404,23406
2023-03-12,24713,9989,Marketing,South,4,1,14724
2021-09-06,20584,11028,Marketing,West,3,64,9556
2023-12-13,13901,18626,IT,North,7,209,-4725
2022-10-01,26450,17325,HR,East,2,1,9125
2020-03-14,37610,13422,Sales,South,3,357,24188
2022-12-14,32061,23883,HR,West,9,189,8178
2022-08-19,25314,29004,HR,West,8,463,-3690
2020-01-24,12090,15673,Operations,South,2,247,-3583
2022-11-11,36852,25688,Operations,West,6,257,11164
2021-03-03,32454,18512,Finance,North,3,465,13942
2022-11-21,21707,19472,Sales,West,6,174,2235
2022-05-12,41567,19900,Finance,North,5,109,21667
2020-12-04,43823,7903,Sales,North,4,60,35920
2021-05-26,42007,12763,Marketing,South,7,43,29244
2022-12-29,49024,15960,Sales,West,7,428,33064
2021-11-02,24141,16084,Marketing,North,4,38,8057
2023-01-16,22746,29348,Marketing,West,3,363,-6602
2022-05-26,13347,15275,Sales,North,4,258,-1928
2021-07-24,19361,7074,Marketing,East,2,82,12287
2022-02-02,14101,12825,HR,South,4,396,1276
2023-05-27,45947,7065,Marketing,South,4,221,38882
2021-12-13,42668,8208,HR,South,5,407,34460
2021-08-11,39610,9674,HR,North,1,111,29936
2022-02-05,27747,14094,HR,East,2,265,13653
2023-07-17,25009,19137,IT,North,8,136,5872
2022-03-29,33651,20310,Finance,South,8,434,13341
2020-03-18,11056,14245,IT,North,8,336,-3189
2020-01-10,42910,5122,Marketing,South,5,318,37788
2023-09-21,21507,22340,Finance,West,8,23,-833
2021-09-27,31215,26480,Finance,North,9,349,4735
2023-04-24,37349,22370,Finance,West,4,59,14979
2023-02-18,40375,14443,Sales,North,4,266,25932
2021-08-14,20076,9433,Marketing,South,7,140,10643
2021-12-18,45249,5990,IT,West,5,446,39259
2021-07-18,20082,29309,Finance,North,1,381,-9227
2023-07-21,29509,10556,Finance,South,8,116,18953
2021-02-13,17050,28209,Operations,North,4,204,-11159
2020-12-23,48779,19650,Finance,West,8,158,29129
2020-04-07,21414,9709,Finance,North,2,330,11705
2022-10-03,46918,29357,Operations,North,4,462,17561
2020-08-28,25876,8580,Marketing,West,2,196,17296
2021-07-10,17004,24186,IT,South,5,431,-7182
2021-12-11,19198,23588,HR,North,8,212,-4390
2023-02-11,37766,5871,IT,North,7,41,31895
2023-06-18,43988,24208,Marketing,East,5,359,19780
2020-06-04,47429,19592,IT,East,7,7,27837
2020-12-17,47634,27479,Operations,South,5,350,20155
2020-02-13,11797,17922,Finance,West,7,372,-6125
2021-08-14,48742,24787,Finance,South,4,105,23955
2023-08-28,23165,27537,HR,South,4,472,-4372
2020-05-17,29255,15383,Marketing,South,4,458,13872
2021-03-11,49773,10550,Finance,North,8,308,39223
2022-01-23,14612,25266,Marketing,North,1,45,-10654
2020-05-22,35280,17774,Sales,South,5,38,17506
2022-10-20,41528,8207,HR,South,2,164,33321
2023-08-15,20283,8097,Marketing,East,4,81,12186
2020-09-18,14953,24462,IT,West,5,341,-9509
2021-05-26,30698,24022,IT,South,8,58,6676
2021-11-03,49819,16278,IT,East,2,302,33541
2020-03-02,32016,26935,IT,South,2,123,5081
2023-12-17,23248,24330,Marketing,West,2,195,-1082
2023-11-20,27276,24855,Operations,South,8,193,2421
2020-01-31,41008,25686,HR,West,3,402,15322
2023-09-15,42213,6624,IT,North,5,386,35589
2022-08-06,27355,20968,Marketing,West,2,104,6387
2022-03-12,26486,16149,Finance,South,6,112,10337
2023-04-07,25139,14717,Finance,East,6,132,10422
2020-09-22,31529,22866,Marketing,North,2,96,8663
2020-11-03,46014,21642,IT,East,4,83,24372
2021-04-03,30096,18640,Sales,South,2,468,11456
2023-04-23,40117,21837,Marketing,North,4,170,18280
2020-11-29,13417,13990,HR,East,7,49,-573
2021-05-29,16445,25854,HR,South,5,433,-9409
2021-03-16,15417,23895,Sales,East,4,373,-8478
2021-11-03,25494,9170,Finance,West,3,135,16324
2021-01-25,23302,29817,Finance,West,6,265,-6515
2022-07-23,46427,10136,Marketing,South,2,199,36291
2021-07-13,42098,6712,Sales,East,4,283,35386
2020-09-10,38803,28810,Marketing,South,8,405,9993
2023-09-20,39164,7002,Marketing,East,2,35,32162
2023-11-24,48441,13151,Sales,North,9,344,35290
2023-04-04,44925,20670,Finance,South,2,480,24255
2023-07-07,43563,11254,Operations,South,8,204,32309
2022-10-24,21389,24711,IT,East,8,471,-3322
2020-04-28,23490,15473,IT,South,7,420,8017
2022-09-22,16044,20303,IT,North,6,241,-4259
2021-04-14,37509,29419,Sales,East,1,349,8090
2022-02-23,37844,24495,Marketing,East,2,323,13349
2022-12-29,31604,26625,Marketing,East,7,43,4979
2021-11-24,37560,18761,HR,North,4,264,18799
2022-05-14,10572,13918,Marketing,North,9,482,-3346
2022-02-14,11206,6831,Finance,South,3,377,4375
2023-10-25,23096,6821,Operations,East,4,78,16275
2020-06-29,39550,6816,IT,North,3,36,32734
2022-10-25,45228,20878,Finance,West,7,383,24350
2023-05-05,30389,21475,Finance,South,2,304,8914
2020-02-16,47693,8432,Operations,North,2,174,39261
2021-09-25,28997,23353,IT,North,2,416,5644
2023-03-09,44483,20482,Sales,North,4,135,24001
2023-12-21,31629,23768,Operations,South,8,330,7861
2021-08-11,44337,8679,Finance,North,8,140,35658
2020-11-05,27060,21986,Marketing,North,8,55,5074
2020-09-30,24605,21811,IT,West,8,252,2794
2022-04-19,45281,13198,HR,West,7,488,32083
2023-11-14,19333,11263,Operations,West,6,279,8070
2021-04-03,39787,23818,Finance,North,7,459,15969
2022-01-02,23923,22757,Sales,West,5,180,1166
2020-12-26,44799,13832,Finance,East,8,13,30967
2022-10-14,14329,16954,HR,West,2,204,-2625
2022-12-28,15322,10162,Sales,West,5,455,5160
2021-10-23,43823,28224,IT,North,7,309,15599
2021-11-29,41076,8811,Operations,East,9,63,32265
2023-12-25,49875,8306,Sales,West,1,492,41569
2022-06-03,48438,13637,HR,North,9,74,34801
2022-01-27,23833,17133,Finance,East,3,455,6700
2022-11-21,28134,19218,HR,West,1,307,8916
2021-09-12,17575,13704,Marketing,North,7,442,3871
2020-06-30,21363,20885,Sales,East,3,155,478
2021-11-16,32771,27740,Operations,West,8,7,5031
2021-11-11,38729,6401,Operations,East,2,375,32328
2020-09-04,45780,15004,Finance,East,4,306,30776
2021-09-11,29812,5545,Finance,North,2,408,24267
2023-08-13,32847,7533,Finance,South,4,343,25314
2020-01-30,15138,7009,Marketing,East,1,153,8129
2023-08-18,34932,10901,HR,East,5,44,24031
2022-05-22,31639,9085,Finance,East,3,36,22554
2022-08-05,47159,7215,Sales,East,9,441,39944
2023-10-07,36199,26369,Finance,East,4,97,9830
2022-09-11,47992,21041,HR,South,6,165,26951
2020-11-12,36241,20763,Sales,North,9,234,15478
2022-01-06,17951,7184,Sales,South,2,103,10767
2023-11-21,23837,15354,Sales,North,7,436,8483
2023-01-17,22688,6275,HR,South,3,381,16413
2023-06-11,19787,14504,Finance,North,1,447,5283
2020-06-16,44757,26552,HR,West,9,7,18205
2022-01-12,35104,8523,HR,East,9,94,26581
2020-05-05,12604,13707,IT,North,4,444,-1103
2021-07-26,41269,26167,HR,North,9,479,15102
2020-04-29,10063,6019,Marketing,East,7,121,4044
2023-12-22,22152,28982,IT,West,4,365,-6830
2022-10-05,29196,6049,Sales,East,2,494,23147
2023-04-28,46795,18381,Finance,North,5,37,28414
2023-12-22,24959,7340,Operations,North,8,21,17619
2021-07-13,42869,28957,Finance,East,6,98,13912
2023-05-10,41280,14449,IT,South,5,302,26831
2022-12-18,37924,23662,IT,East,4,21,14262
2021-11-27,37467,20622,Sales,North,6,232,16845
2020-08-10,26056,7985,HR,North,3,468,18071
2022-10-31,13135,17061,HR,North,2,354,-3926
2022-03-03,27564,10705,IT,West,1,72,16859
2022-03-24,48277,22528,HR,East,9,352,25749
2020-11-05,37462,29014,IT,West,1,52,8448
2022-10-08,12728,5705,Finance,East,4,222,7023
2022-01-18,17631,23808,Operations,West,6,285,-6177
2022-11-23,20884,23318,Finance,South,9,325,-2434
2022-10-15,34974,7484,Operations,North,4,478,27490
2023-09-25,45641,28380,Sales,North,7,460,17261
2021-04-25,46036,6745,Marketing,East,7,167,39291
2021-07-27,29078,27148,Marketing,North,6,283,1930
2022-04-04,20274,21216,Finance,West,9,205,-942
2023-01-21,28851,14161,HR,South,7,367,14690
2021-09-19,13959,23930,Marketing,West,3,138,-9971
2023-03-02,33224,18974,Operations,West,6,36,14250
2022-04-23,23894,27012,Sales,East,7,95,-3118
2022-09-15,36965,5777,Operations,North,7,16,31188
2021-02-22,47616,14525,IT,West,6,487,33091
2020-01-30,40558,15309,HR,East,3,237,25249
2020-10-24,25690,15580,HR,West,6,164,10110
2022-12-20,43447,8114,Marketing,West,2,90,35333
2021-04-02,27131,17405,IT,West,1,108,9726
2020-10-30,37429,7936,Marketing,East,8,84,29493
2022-08-15,27705,25494,Marketing,South,3,255,2211
2020-12-05,32246,6345,Marketing,West,8,418,25901
2021-03-23,14789,7041,IT,West,3,165,7748
2023-08-18,10533,19330,Marketing,East,2,200,-8797
2022-05-30,38776,18198,HR,North,8,324,20578
2021-06-23,28725,24058,Marketing,South,3,315,4667
2021-04-29,16694,12504,IT,East,8,157,4190
2020-03-17,15006,14747,IT,North,2,31,259
2021-05-29,36998,22073,Operations,East,4,66,14925
2022-08-01,47313,28440,Marketing,East,9,89,18873
2021-10-20,40087,5119,IT,South,1,486,34968
2020-04-01,47675,11169,Finance,South,2,259,36506
2021-04-10,34362,10832,Marketing,South,2,253,23530
2021-04-10,14485,19649,Sales,South,9,494,-5164
2022-11-29,11235,17246,HR,North,5,234,-6011
2021-11-20,41983,6613,HR,West,4,107,35370
2023-09-14,34039,20575,Finance,East,4,69,13464
2023-08-01,40416,12623,Marketing,South,7,278,27793
2022-08-04,11145,8033,HR,West,3,336,3112
2021-07-07,33804,24320,HR,North,9,201,9484
2022-12-25,11475,10659,Sales,South,5,53,816
2020-04-18,20047,17255,HR,East,9,432,2792
2023-12-09,22156,17080,HR,West,1,457,5076
2020-04-01,40421,16976,IT,South,8,241,23445
2022-09-29,37955,15818,HR,East,2,332,22137
2021-01-02,32063,20718,Marketing,West,8,175,11345
2022-03-30,31799,14341,HR,East,4,42,17458
2021-02-26,31322,26451,Marketing,North,2,260,4871
2021-07-25,44372,20196,HR,South,2,369,24176
2022-05-11,24932,26186,Marketing,South,6,210,-1254
2023-06-17,47815,21296,HR,East,3,466,26519
2021-03-10,34003,24542,Finance,West,3,42,9461
2020-07-30,32501,19134,Marketing,South,9,427,13367
2023-11-24,41092,17241,HR,East,5,353,23851
2021-06-09,24983,25874,Sales,North,7,170,-891
2021-04-12,39768,5455,IT,South,5,382,34313
2023-04-08,44604,12643,IT,East,2,259,31961
2022-03-02,32288,9620,IT,West,8,443,22668
2022-05-24,16476,13867,IT,South,9,486,2609
2020-07-28,42602,21126,Sales,South,2,337,21476
2020-09-12,19962,10099,Finance,North,2,204,9863
2020-03-13,38439,18887,Finance,East,4,395,19552
2020-05-26,13400,15546,Sales,West,8,337,-2146
2023-09-25,34440,20435,HR,North,5,163,14005
2020-11-12,34610,5059,Sales,North,5,105,29551
2021-08-28,39575,17673,IT,North,7,178,21902
2021-07-28,29728,27583,Finance,East,4,191,2145
2023-03-23,39067,27695,Operations,East,9,124,11372
2023-07-02,34303,10531,HR,South,4,198,23772
2023-10-06,11628,7764,Marketing,East,8,99,3864
2021-06-30,49532,28392,Finance,North,3,6,21140
2022-04-14,19521,6794,IT,East,6,288,12727
2020-11-07,48513,15721,Finance,West,1,267,32792
2022-03-18,35380,10686,IT,South,7,43,24694
2022-02-03,38923,24871,IT,North,7,295,14052
2020-05-13,44058,19675,Finance,South,2,141,24383
2022-08-05,38880,9987,Finance,East,5,269,28893
2023-02-26,28970,24805,Finance,South,4,39,4165
2021-03-11,48891,17888,Sales,South,9,430,31003
2023-07-27,14930,11580,Finance,East,2,162,3350
2020-12-23,45318,18533,Marketing,South,3,195,26785
2022-07-18,39843,26916,HR,East,1,416,12927
2022-06-01,42574,22757,IT,North,5,324,19817
2020-09-08,49751,8553,Finance,South,3,104,41198
2020-05-14,19857,25056,Marketing,West,4,245,-5199
2021-06-06,33513,13144,Operations,West,4,65,20369
2022-03-14,44898,14274,Finance,North,6,201,30624
2021-10-21,33593,17439,Sales,East,7,369,16154
2020-11-14,32683,10437,IT,East,7,242,22246
2020-03-20,46508,29547,Marketing,South,8,7,16961
2023-04-29,28884,28830,Finance,South,3,219,54
2023-09-29,15307,17277,Marketing,West,5,3,-1970
2022-11-19,22904,13749,IT,West,6,342,9155
2021-02-17,49535,18785,Marketing,East,6,464,30750
2021-01-02,27881,27349,Marketing,West,8,456,532
2022-10-03,39178,10915,Finance,East,5,453,28263
2022-09-19,23582,14734,Finance,North,5,305,8848
2021-08-18,45912,19703,HR,North,1,314,26209
2022-10-14,18025,27499,Sales,West,1,478,-9474
2021-12-01,29188,26478,HR,South,6,284,2710
2022-11-10,17604,7382,Sales,West,5,371,10222
2021-07-02,49907,25482,Sales,West,6,411,24425
2020-09-02,37290,14473,HR,West,9,498,22817
2020-10-09,16203,9358,IT,South,8,22,6845
2021-09-05,17871,13312,Marketing,West,7,94,4559
2022-07-19,24662,19031,Operations,South,7,357,5631
2022-03-16,46782,5139,HR,West,6,71,41643
2020-08-19,21445,12644,HR,South,6,370,8801
2020-11-11,21038,6815,IT,South,1,222,14223
2022-04-17,13505,26792,Marketing,South,7,13,-13287
2023-09-21,29069,9301,Finance,South,5,406,19768
2021-02-14,24418,17330,HR,South,7,459,7088
2020-09-01,26411,20185,Operations,North,6,5,6226
2021-01-21,43033,12285,Marketing,East,8,22,30748
2021-11-19,19498,14220,HR,East,3,463,5278
2020-12-23,31459,15446,Finance,South,8,383,16013
2022-10-18,32203,28162,HR,East,7,309,4041
2021-09-05,38030,19150,Finance,South,1,295,18880
2022-03-08,31060,13536,Sales,West,3,37,17524
2020-01-22,29774,23803,Sales,North,4,31,5971
2020-01-19,43378,8235,HR,West,9,62,35143
2023-08-03,30930,23978,IT,West,6,221,6952
2020-10-02,23493,6387,Sales,South,7,359,17106
2021-10-20,47795,17209,HR,West,5,81,30586
2022-06-16,23638,5983,Finance,North,3,383,17655
2021-07-05,15724,19346,Marketing,West,5,233,-3622
2021-11-09,10202,23506,Finance,North,7,6,-13304
2021-08-25,43169,26803,Operations,North,9,105,16366
2022-12-31,12027,24378,Sales,South,9,337,-12351
2020-12-30,24807,28440,HR,North,8,162,-3633
2022-03-05,38426,12548,Sales,West,5,343,25878
2023-09-20,10178,11853,Finance,South,7,52,-1675
2021-10-13,15817,24284,Finance,North,4,158,-8467
2021-08-12,44747,5775,Marketing,North,5,13,38972
2020-07-17,17185,26365,IT,East,4,186,-9180
2020-01-17,13984,22119,HR,South,3,222,-8135
2020-08-05,32049,28161,Marketing,East,1,241,3888
2022-01-10,31405,29137,Operations,North,5,309,2268
2021-10-11,20236,26531,HR,East,2,148,-6295
2020-05-26,31896,22870,Operations,West,6,390,9026
2023-05-18,45751,21779,IT,West,5,55,23972
2021-10-31,24635,17970,HR,North,2,415,6665
2023-12-08,18542,7001,HR,East,8,59,11541
2021-10-26,47050,16639,Marketing,East,5,403,30411
2022-05-05,41342,19756,Sales,South,2,198,21586
2020-11-25,17988,29939,HR,West,1,98,-11951
2022-06-13,42070,13062,IT,West,2,156,29008
2023-10-07,41955,15046,HR,South,1,250,26909
2023-04-01,22596,28652,HR,West,3,397,-6056
2020-04-10,33659,27261,HR,East,3,180,6398
2020-11-22,20416,9188,HR,East,1,74,11228
2020-11-22,29171,18886,IT,West,7,61,10285
2023-03-24,42577,25745,Marketing,South,7,425,16832
2020-01-10,32736,11349,Sales,North,9,45,21387
2020-12-18,14808,11180,IT,North,5,135,3628
2020-07-01,48656,18322,IT,North,4,210,30334
2021-03-30,15737,12794,Operations,North,5,86,2943
2020-01-06,45126,18401,Sales,East,8,270,26725
2023-09-18,39652,22127,Marketing,North,8,292,17525
2023-09-18,15390,11162,Finance,East,4,264,4228
2023-07-05,30600,20923,Marketing,East,8,268,9677
2020-07-29,10406,21757,Finance,North,4,424,-11351
2020-02-20,42764,10905,Operations,North,4,496,31859
2022-10-06,42995,25511,Operations,North,8,225,17484
2021-01-11,28568,17276,IT,West,2,216,11292
2021-10-01,20433,29715,Marketing,West,4,362,-9282
2022-02-08,39377,10689,Finance,South,1,231,28688
2022-12-10,33184,24404,Marketing,East,1,190,8780
2020-06-02,19121,20380,Finance,North,8,142,-1259
2021-08-04,38612,20508,Marketing,West,4,177,18104
2022-02-26,32207,24676,IT,South,6,51,7531
2022-03-01,20795,28260,Finance,East,5,190,-7465
2023-08-26,27564,11897,Marketing,East,6,5,15667
2023-11-23,11101,26722,HR,East,4,211,-15621
2020-05-13,44867,6564,Operations,West,4,195,38303
2020-08-07,10513,21334,Operations,North,7,1,-10821
2020-06-11,21324,18870,Finance,North,1,104,2454
2022-08-28,25491,19219,Operations,East,9,361,6272
2021-10-09,23693,21441,Operations,East,3,101,2252
2021-07-22,25923,24880,HR,South,4,128,1043
2022-08-03,44600,26778,Sales,South,9,353,17822
2021-11-19,20872,15379,Marketing,East,5,305,5493
2020-04-24,17137,26526,Finance,South,4,249,-9389
2023-03-18,21358,7948,Operations,West,6,494,13410
2023-06-18,15807,25857,Marketing,East,1,401,-10050
2020-05-02,36503,29948,Marketing,South,1,457,6555
2022-03-14,24859,8134,HR,East,5,351,16725
2022-04-18,32234,22971,Marketing,North,5,291,9263
2022-12-28,21079,13969,Operations,West,9,451,7110
2022-04-05,40975,25646,Finance,East,1,269,15329
2020-03-03,14343,28050,Marketing,North,3,372,-13707
2022-01-02,14628,8678,HR,East,3,421,5950
2022-11-05,32568,15740,Finance,North,4,38,16828
2023-11-14,38106,22382,Finance,South,7,334,15724
2021-08-12,18981,8343,Finance,North,7,390,10638
2022-08-05,44068,24885,Operations,West,5,250,19183
2023-07-05,44715,9014,HR,West,9,221,35701
2020-08-04,12242,10107,IT,South,7,63,2135
2021-04-23,46424,16870,Sales,East,2,253,29554
2023-02-11,44218,9328,Marketing,West,3,433,34890
2023-11-04,12842,9655,Marketing,South,7,265,3187
2022-09-03,26017,26711,Marketing,West,5,164,-694
2020-08-24,23836,29004,IT,South,7,23,-5168
2021-04-20,24186,10858,Finance,West,9,79,13328
2021-08-20,44432,10620,Finance,South,9,118,33812
2020-05-08,32757,14112,Sales,West,3,185,18645
2021-05-24,41116,12004,HR,East,8,434,29112
2020-06-13,46716,6242,IT,North,6,495,40474
2020-10-03,30456,28399,IT,West,4,59,2057
2020-09-13,13634,21464,Operations,South,4,370,-7830
2023-03-01,45840,7661,Finance,East,4,391,38179
2022-09-18,30856,9798,IT,West,7,303,21058
2021-07-23,12459,5540,IT,South,6,252,6919
2023-07-04,46474,27329,Marketing,North,2,89,19145
2020-05-20,41519,28292,Finance,South,5,229,13227
2021-11-16,27590,24169,Operations,West,5,343,3421
2021-11-17,18601,24870,HR,South,6,331,-6269
2023-05-17,13469,8157,Sales,South,7,440,5312
2021-12-16,34791,9717,HR,North,8,238,25074
2022-10-19,47615,10336,Operations,West,8,392,37279
2022-12-10,10348,12165,Marketing,West,5,292,-1817
2023-07-06,46419,23627,Sales,North,2,426,22792
2020-06-26,12878,14512,HR,East,8,295,-1634
2022-07-10,21857,24377,Finance,South,6,321,-2520
2021-06-26,47517,23475,Finance,South,3,44,24042
2023-10-11,30378,19728,Sales,South,4,333,10650
2023-09-03,10002,18754,Sales,West,1,80,-8752
2022-08-20,35658,10209,Sales,West,3,174,25449
2020-12-29,33267,19490,IT,South,4,141,13777
2022-12-14,24353,12645,Operations,West,2,37,11708
2023-03-25,11517,10740,Finance,North,6,14,777
2022-12-03,29963,9154,Finance,North,8,122,20809
2021-08-15,23175,7665,Operations,West,6,397,15510
2021-06-25,40367,11018,Marketing,South,3,238,29349
2020-11-17,27232,23140,Finance,South,9,396,4092
2021-10-09,47804,10713,HR,South,4,55,37091
2020-01-14,36468,18071,Marketing,South,6,412,18397
2023-10-12,10520,24504,HR,West,4,22,-13984
2021-09-09,31497,26535,Sales,East,4,340,4962
2020-12-24,36927,26989,Finance,East,2,495,9938
2023-09-03,16258,20327,HR,South,2,403,-4069
2023-01-03,44902,23962,HR,South,2,203,20940
2020-07-12,25454,6026,Sales,South,2,414,19428
2020-12-28,47606,9473,Marketing,East,8,438,38133
2023-01-24,30929,9667,HR,North,4,346,21262
2022-11-29,34177,23338,Finance,East,4,15,10839
2022-02-06,10785,21970,Marketing,West,3,30,-11185
2021-01-31,18143,20941,Marketing,East,5,29,-2798
2020-04-16,34092,5684,Operations,West,4,252,28408
2022-11-06,23635,27426,Finance,South,7,160,-3791
2021-06-10,20982,8268,Finance,West,7,117,12714
2022-10-07,23409,20193,Sales,South,6,158,3216
2022-02-22,28541,5658,Sales,North,7,108,22883
2021-06-08,13528,6296,IT,South,7,115,7232
2022-12-02,46327,6525,Finance,South,8,272,39802
2021-09-17,34518,15274,Marketing,North,1,420,19244
2020-12-15,34946,12150,IT,South,3,338,22796
2022-11-19,42080,12792,Finance,South,3,489,29288
2022-10-02,45705,11604,Sales,South,5,176,34101
2021-06-25,34556,20053,Sales,East,7,231,14503
2022-08-19,47909,10789,Finance,West,6,284,37120
2020-04-03,31775,12420,IT,South,4,318,19355
2023-08-11,34041,10753,Sales,East,6,250,23288
2022-06-17,10835,20544,Sales,South,7,467,-9709
2020-03-29,45747,28018,Operations,West,4,440,17729
2021-05-17,45192,10108,HR,South,8,56,35084
2022-02-05,26104,10247,Finance,West,5,331,15857
2020-08-01,24927,13401,Operations,East,3,273,11526
2023-12-16,14521,22007,HR,East,2,190,-7486
2021-06-09,24280,14997,Finance,South,1,21,9283
2020-07-10,40753,10261,Operations,North,4,165,30492
2021-11-24,13459,9268,Operations,West,2,492,4191
2021-10-03,39435,10984,Finance,South,3,371,28451
2023-06-01,38077,25133,Marketing,East,1,418,12944
2021-07-08,11148,25926,IT,South,6,481,-14778
2021-01-21,47345,5010,Finance,West,4,285,42335
2021-11-11,41036,22144,Operations,South,5,68,18892
2022-02-14,30002,6177,Marketing,West,8,480,23825
2020-07-21,49398,14168,Operations,East,4,444,35230
2022-10-06,46490,23876,IT,North,6,267,22614
2021-03-22,15930,7389,Marketing,North,3,218,8541
2022-06-18,23388,11364,Finance,East,8,338,12024
2022-12-27,29691,20777,HR,East,3,384,8914
2023-01-20,13642,16865,IT,South,7,373,-3223
2022-02-16,29201,23936,Sales,East,7,96,5265
2020-06-26,17421,17327,Finance,East,3,188,94
2022-04-08,49815,22866,Finance,West,3,475,26949
2021-07-12,23554,7310,Finance,South,8,208,16244
2022-10-23,15588,8741,Marketing,West,3,74,6847
2020-04-12,33771,12285,Sales,South,2,364,21486
2023-07-20,35824,29001,Marketing,South,5,162,6823
2020-04-25,19316,8839,HR,North,7,161,10477
2022-05-08,38234,12581,Marketing,North,8,394,25653
2021-04-08,29786,24139,Finance,East,1,490,5647
2020-04-13,47100,19137,Operations,South,2,60,27963
2020-09-15,25329,24981,Sales,East,7,26,348
2023-08-24,25698,10237,Sales,West,9,362,15461
2023-10-22,35327,17504,Marketing,East,3,25,17823
2022-07-17,26548,6740,Operations,West,8,258,19808
2022-03-20,49757,23508,Operations,North,3,346,26249
2021-10-03,28340,10291,Marketing,North,4,340,18049
2022-03-17,13860,24481,IT,West,2,3,-10621
2022-10-19,29159,10247,HR,West,9,288,18912
2023-08-18,37865,25853,Marketing,West,5,257,12012
2021-07-13,44536,13845,Finance,East,5,280,30691
2020-01-27,41755,26383,Operations,West,4,306,15372
2021-05-22,23743,16733,HR,South,5,427,7010
2021-06-10,16226,11566,Marketing,West,1,248,4660
2022-02-13,22718,28728,HR,North,6,44,-6010
2023-10-20,49389,5852,IT,West,4,33,43537
2022-08-10,35530,26310,Operations,North,4,294,9220
2020-10-24,42908,14753,IT,North,5,112,28155
2022-02-15,11650,26452,IT,East,1,308,-14802
2020-12-26,43783,17137,Operations,West,4,291,26646
2021-05-18,16292,15868,Finance,North,3,273,424
2021-08-10,32737,19905,IT,South,5,314,12832
2020-01-30,35551,26773,Marketing,West,5,304,8778
2023-09-25,29504,22702,Marketing,West,8,43,6802
2020-05-05,26371,21505,HR,North,1,304,4866
2021-08-18,30810,9254,Marketing,East,3,44,21556
2023-10-21,39036,21239,Marketing,East,5,289,17797
2020-09-19,25547,13498,HR,West,3,459,12049
2022-07-24,37203,17174,Sales,West,6,87,20029
2022-05-21,19305,6896,Operations,East,3,230,12409
2023-05-30,18813,17878,Marketing,East,6,480,935
2020-01-02,10900,10976,HR,South,8,83,-76
2021-01-28,13747,29390,IT,West,4,204,-15643
2020-11-01,33245,29921,IT,West,8,476,3324
2023-03-15,13103,8911,Finance,West,7,130,4192
2021-06-13,10073,21337,Marketing,East,4,138,-11264
2021-06-11,12497,13340,Operations,North,3,83,-843
2023-08-24,39577,22423,HR,South,5,412,17154
2022-08-22,31012,14582,Finance,East,5,175,16430
2021-11-01,18487,8904,Finance,East,7,136,9583
2023-09-25,40023,9876,HR,South,1,107,30147
2020-12-17,34877,13309,HR,West,9,151,21568
2022-03-20,16517,5703,HR,North,2,432,10814
2020-07-27,15615,24339,HR,South,9,109,-8724
2022-08-15,20468,10470,Operations,North,9,222,9998
2020-07-23,20879,11440,HR,West,3,348,9439
2021-09-16,41955,7024,Operations,North,7,319,34931
2021-12-21,23078,20751,Operations,West,3,333,2327
2021-09-27,14590,17730,Operations,East,8,247,-3140
2022-11-04,20910,26380,IT,West,8,37,-5470
2022-05-07,41976,27953,Sales,South,3,268,14023
2023-12-22,31574,9345,Finance,South,5,74,22229
2021-04-20,32716,15149,Marketing,West,7,115,17567
2020-10-24,43430,27246,IT,West,1,81,16184
2021-07-10,18199,10634,Sales,East,3,193,7565
2023-01-22,43436,22381,Finance,East,1,214,21055
2020-04-16,37740,21789,IT,West,2,15,15951
2023-12-13,19477,16040,Finance,North,7,336,3437
2023-07-25,10160,5243,Operations,East,7,84,4917
2020-05-07,16460,29351,Operations,South,3,375,-12891
2021-04-03,26401,7414,HR,East,6,266,18987
2020-02-07,45301,8856,Operations,East,6,298,36445
2020-07-16,32894,11263,IT,East,2,154,21631
2020-12-22,47214,20185,Finance,East,9,305,27029
2020-01-07,48322,20799,Marketing,West,8,253,27523
2023-09-17,12918,29322,Finance,East,2,407,-16404
2021-06-02,35629,13624,Operations,North,4,448,22005
2020-07-12,26699,17470,Finance,East,9,273,9229
2020-11-11,17069,18772,Sales,East,4,418,-1703
2022-10-21,49190,6141,Finance,South,7,361,43049
2022-12-21,14527,9126,IT,East,5,313,5401
2020-12-08,29099,24408,Sales,South,6,342,4691
2021-08-23,25622,19863,HR,South,1,132,5759
2022-11-07,36281,18584,HR,West,4,199,17697
2021-09-11,49433,28391,Finance,South,5,325,21042
2023-10-26,49875,24840,Marketing,South,6,351,25035
2022-04-01,25531,27383,IT,North,6,83,-1852
2020-08-22,15132,9197,Marketing,North,5,452,5935
2022-12-28,39396,10824,Sales,South,3,306,28572
2021-03-22,37807,17097,Marketing,West,2,126,20710
2021-09-01,49550,28150,Sales,North,7,214,21400
2020-01-08,37196,24236,Marketing,North,1,323,12960
2021-04-06,25993,23839,HR,West,5,215,2154
2022-09-26,35958,28898,IT,East,4,452,7060
2023-08-27,49513,17115,Marketing,North,7,238,32398
2020-05-13,48402,22774,Finance,South,2,88,25628
2021-01-19,49028,9925,Sales,South,8,384,39103
2020-02-25,24945,24220,Finance,South,9,443,725
2022-09-19,27569,22001,IT,West,1,462,5568
2023-10-15,33379,7469,Finance,South,5,113,25910
2023-02-11,48877,17468,HR,East,4,105,31409
2023-01-16,32825,7702,HR,West,5,371,25123
2020-05-17,10915,11257,Operations,North,9,63,-342
2023-02-05,33848,13105,IT,West,3,451,20743
2021-06-18,23669,8165,Marketing,South,1,239,15504
2020-05-23,19875,29835,HR,West,3,469,-9960
2022-05-18,24853,16370,Marketing,West,4,26,8483
2021-10-17,12425,15483,Marketing,West,2,128,-3058
2020-02-25,42440,19758,Sales,West,1,1,22682
2021-09-11,43193,9430,Finance,East,1,94,33763
2022-10-26,44555,14238,Marketing,West,8,371,30317
2021-06-25,45352,10992,Operations,South,4,452,34360
2021-03-22,47416,17249,IT,North,2,462,30167
2023-11-09,26552,11597,IT,East,3,402,14955
2023-08-23,43282,6407,Sales,West,8,12,36875
2022-05-23,46203,14201,Operations,North,6,166,32002
2021-09-30,47293,10557,Finance,East,8,298,36736
2023-08-18,29000,28383,Operations,South,5,420,617
2023-11-29,40802,28973,IT,South,3,272,11829
2021-09-02,20569,20515,Operations,North,6,449,54
2022-04-16,35266,8406,Finance,West,8,67,26860
2022-02-18,13204,16794,HR,North,5,167,-3590
2022-04-16,17765,10700,Marketing,East,5,254,7065
2021-05-24,20696,13127,Marketing,North,3,355,7569
2023-01-01,34928,25611,IT,North,3,253,9317
2022-03-22,24679,15740,IT,West,8,246,8939
2021-07-17,43885,6545,Finance,South,1,59,37340
2020-09-21,44173,28691,Operations,West,4,463,15482
2023-06-04,48182,29516,Finance,South,9,294,18666
2023-05-01,49109,21518,Sales,West,6,144,27591
2023-10-29,14174,7859,IT,South,6,209,6315
2020-01-10,27061,18057,IT,West,7,226,9004
2020-10-28,35395,11003,IT,South,7,458,24392
2023-10-14,10213,6264,Finance,South,6,395,3949
2022-03-15,44434,23156,Finance,South,9,284,21278
2022-12-11,23276,21548,Operations,South,8,91,1728
2020-04-08,19085,17612,HR,West,8,486,1473
2021-08-15,38481,21019,IT,East,2,466,17462
2022-11-02,41276,20577,HR,South,7,111,20699
2023-11-14,34597,13811,Finance,South,1,240,20786
2020-12-22,32244,29806,Operations,South,8,350,2438
2022-07-16,40601,11725,Finance,South,3,333,28876
2020-01-11,44029,24164,Sales,South,9,80,19865
2020-03-21,31264,29137,Marketing,North,5,386,2127
2023-07-08,23890,26682,Marketing,North,7,404,-2792
2020-01-06,31058,11814,Finance,South,7,204,19244
2021-01-07,26121,25136,Marketing,South,9,477,985
2021-04-25,47964,21185,Marketing,South,2,238,26779
2020-08-09,47352,8972,Operations,East,4,328,38380
2023-01-09,15021,24616,Marketing,West,8,294,-9595
2021-05-29,32614,12594,Operations,South,5,494,20020
2022-12-19,12631,21786,Sales,East,5,184,-9155
2020-08-08,16345,12199,IT,East,3,495,4146
2020-12-14,36844,11264,IT,South,5,212,25580
2020-08-15,16300,20874,IT,West,7,251,-4574
2020-10-16,48612,9480,Operations,North,4,227,39132
2020-10-19,28560,11619,Operations,South,8,167,16941
2022-03-20,15362,7607,Operations,South,6,31,7755
2023-05-01,18097,14382,Sales,North,6,336,3715
2022-08-13,15599,13580,HR,West,6,151,2019
2023-07-04,35452,24788,Operations,North,4,162,10664
2021-01-22,14258,27026,Operations,South,3,96,-12768
2021-09-06,35530,22173,IT,South,6,273,13357
2023-11-22,16640,28280,Finance,East,6,363,-11640
2020-12-31,47056,6494,Marketing,North,2,24,40562
2021-10-19,27261,24135,Marketing,East,9,419,3126
2020-10-16,47827,19388,Sales,East,4,118,28439
2023-08-25,25141,11710,Marketing,East,4,407,13431
2023-07-25,36752,5820,HR,East,8,392,30932
2020-07-07,33548,26524,IT,North,3,438,7024
2022-07-06,45368,26522,Sales,North,7,87,18846
2023-04-16,25902,17228,Marketing,North,7,405,8674
2022-07-12,37683,23753,Marketing,South,2,275,13930
2022-09-14,28792,25449,Finance,West,3,415,3343
2021-01-09,47628,22847,IT,East,4,50,24781
2022-01-29,12334,23291,Sales,South,2,327,-10957
2020-08-04,10767,27585,IT,North,9,112,-16818
2022-12-01,41644,16257,Sales,North,6,280,25387
2020-07-12,36992,29279,Marketing,South,1,302,7713
2023-09-12,39570,16837,IT,East,1,136,22733
2023-10-28,21737,29209,IT,North,8,333,-7472
2020-06-11,23372,17220,HR,East,6,3,6152
2020-10-02,36885,8965,Finance,East,7,162,27920
2020-12-29,30590,18038,IT,West,6,77,12552
2022-02-13,49853,14508,Sales,North,2,185,35345
2021-04-24,10744,21565,HR,South,3,374,-10821
2021-11-19,37158,11000,IT,West,8,58,26158
2021-04-04,30558,28629,IT,East,4,480,1929
2023-07-12,42259,14152,HR,South,8,163,28107
2021-06-22,31450,22373,Marketing,West,3,21,9077
2022-08-31,46929,14917,IT,West,2,65,32012
2023-11-10,19586,27656,Operations,West,7,66,-8070
2020-03-25,10286,19654,Finance,East,1,441,-9368
2023-09-01,13247,5706,Marketing,East,3,298,7541
2020-08-30,41974,28036,IT,North,2,299,13938
2022-05-29,15099,9847,Marketing,West,5,282,5252
2023-09-27,26387,25714,Sales,South,2,451,673
2023-04-15,32319,23004,Marketing,East,5,472,9315
2023-02-27,10411,17893,HR,West,3,410,-7482
2021-10-18,30729,9649,IT,South,9,392,21080
2023-01-11,30111,16613,Marketing,East,9,175,13498
2023-10-15,25704,11596,Operations,South,8,165,14108
2020-03-28,20109,26065,Sales,South,5,456,-5956
2022-01-11,11356,29428,Sales,North,7,82,-18072
2022-09-11,41172,24964,Marketing,East,2,146,16208
2021-04-15,18349,18938,HR,East,3,204,-589
2023-10-09,27984,13614,Sales,East,2,164,14370
2021-02-19,37460,25399,Marketing,East,1,104,12061
2022-12-10,48474,24580,Marketing,North,3,130,23894
2021-11-12,17196,27533,Sales,North,4,84,-10337
2022-12-22,31457,25937,Marketing,West,9,120,5520
2023-01-17,23549,15106,Marketing,East,2,259,8443
2023-04-28,19821,25394,Finance,South,9,104,-5573
2022-06-17,45564,17277,Operations,North,1,364,28287
2021-08-23,21073,28049,Marketing,South,9,34,-6976
2023-10-03,17282,20448,Finance,South,6,382,-3166
2023-04-14,49719,18133,Finance,South,8,369,31586
2023-10-19,29189,16374,Marketing,West,3,366,12815
2022-02-14,46848,9646,HR,West,8,174,37202
2022-06-19,19247,18708,Sales,East,9,446,539
2021-04-27,20771,11090,Finance,North,7,326,9681
2023-02-16,32234,25134,Finance,East,4,232,7100
2020-06-17,33746,17784,HR,West,6,185,15962
2020-05-26,44096,16279,IT,West,6,394,27817
2023-12-31,22236,20392,HR,South,2,344,1844
2021-03-14,45921,15984,IT,East,2,18,29937
2022-06-06,34576,7536,IT,South,5,417,27040
2023-04-27,10166,24643,HR,West,1,231,-14477
2020-06-08,24652,11879,Operations,East,5,135,12773
2022-03-24,29638,19793,HR,East,3,45,9845
2021-02-05,31444,12438,Finance,North,3,112,19006
2021-08-08,25233,23895,Sales,West,8,492,1338
2022-05-13,11885,23474,HR,West,3,413,-11589
2022-11-07,40364,9634,Operations,North,3,83,30730
2020-05-19,24708,21951,HR,West,1,422,2757
2023-02-12,43667,21504,Operations,South,8,39,22163
2020-11-23,45016,11768,Sales,South,6,254,33248
2020-08-12,13412,13507,Marketing,South,8,409,-95
2021-07-11,21769,20357,Operations,East,3,145,1412
2021-03-14,25947,5620,Operations,South,6,317,20327
2021-01-20,16449,25447,Finance,West,2,51,-8998
2021-06-04,45900,5453,Operations,North,3,293,40447
2023-06-30,18136,24118,Sales,South,4,67,-5982
2021-09-11,43127,18831,IT,South,9,24,24296
2023-01-26,16450,5958,Operations,East,4,122,10492
2022-02-25,34031,15200,Sales,West,7,466,18831
2022-12-30,41052,5762,Finance,North,8,49,35290
2021-07-04,21346,25719,Finance,West,5,474,-4373
2021-03-22,24852,20069,Marketing,South,2,149,4783
2023-01-18,17067,18697,Operations,West,8,459,-1630
2023-12-24,41485,27904,IT,North,5,185,13581
2023-05-27,19689,23435,Sales,South,5,250,-3746
2020-04-16,27801,20129,Marketing,West,7,425,7672
2022-07-04,34272,28373,IT,North,6,145,5899
2022-06-22,13763,13388,Marketing,South,3,243,375
2021-06-27,49696,29191,IT,South,7,365,20505
2023-02-23,40075,21644,HR,West,1,358,18431
2023-03-16,38692,11746,HR,East,4,149,26946
2020-10-06,36549,10890,HR,East,4,68,25659
2020-01-24,10878,11053,Marketing,North,6,224,-175
2022-08-09,38848,6280,HR,West,6,210,32568
2020-04-29,40741,21519,Sales,North,8,192,19222
2023-08-13,29268,27483,Sales,West,1,300,1785
2022-05-04,20787,12877,HR,North,7,124,7910
2022-10-12,41671,7545,IT,North,4,284,34126
2022-08-01,21336,19447,IT,West,6,292,1889
2023-01-10,37738,16677,Marketing,East,9,421,21061
2021-03-23,23487,13560,IT,North,3,383,9927
2022-09-22,44037,8662,Operations,West,8,300,35375
2023-12-17,22898,20737,IT,West,3,50,2161
2022-11-13,27678,18055,Sales,West,6,474,9623
2022-12-20,28141,11729,Finance,South,2,369,16412
2020-03-24,20156,24838,IT,West,9,183,-4682
2020-08-12,34160,17798,Marketing,West,2,247,16362
2020-07-04,22835,9808,IT,South,5,88,13027
2021-01-09,19383,13048,Marketing,South,6,138,6335
2020-03-12,49346,18107,Operations,East,4,38,31239
2020-03-14,34564,11520,HR,West,7,49,23044
2023-09-26,29225,21928,Operations,North,7,72,7297
2020-06-01,48484,27600,Sales,South,7,258,20884
2020-04-05,29946,28501,Finance,South,7,44,1445
2021-03-20,38280,25983,Operations,East,9,291,12297
2023-02-07,36295,8423,Operations,East,2,116,27872
2022-04-07,42700,26189,Sales,East,5,149,16511
2022-12-10,45536,9483,Sales,West,9,313,36053
2021-01-11,42609,28355,HR,West,2,347,14254
2022-02-03,19751,17527,HR,West,3,279,2224
2023-01-01,18928,12119,IT,South,7,288,6809
2020-07-30,16142,22481,Marketing,East,9,218,-6339
2023-12-26,26257,15718,Sales,South,3,71,10539
2021-12-24,32650,20373,Operations,North,8,161,12277
2023-04-06,48181,28244,Operations,West,8,273,19937
2022-02-13,33212,10435,HR,South,4,127,22777
2020-11-26,12190,17355,Marketing,North,6,456,-5165
2022-01-20,11002,23327,Sales,South,8,170,-12325
2023-03-12,33038,6719,HR,North,9,17,26319
2022-04-03,18094,10768,Marketing,South,2,304,7326
2021-01-28,32451,29866,Sales,South,1,490,2585
2021-05-26,13752,16881,Operations,West,5,239,-3129
2021-11-16,30521,14166,Operations,South,3,176,16355
2021-09-12,37768,21798,HR,South,6,210,15970
2023-09-13,38410,14042,Marketing,East,1,484,24368
2021-08-26,47206,28489,Operations,South,4,57,18717
2023-07-06,14427,16969,Marketing,West,6,359,-2542
2023-12-31,15556,24112,HR,South,2,189,-8556
2021-12-18,28772,12203,IT,West,8,44,16569
2020-12-14,38063,9641,Marketing,East,4,407,28422
2021-05-29,49760,19374,Finance,West,2,460,30386
2021-02-02,32709,19546,Marketing,East,1,122,13163
2020-08-01,25319,22125,HR,East,8,471,3194
2021-07-15,15383,19102,Finance,East,1,309,-3719
2023-08-05,11233,5591,IT,East,7,33,5642
2023-07-06,37146,5749,Operations,East,7,312,31397
2020-09-14,34713,7219,Sales,West,6,28,27494
2023-11-12,24789,14029,HR,East,8,492,10760
2021-11-24,12930,19777,Sales,East,1,151,-6847
2023-07-12,22112,16322,IT,East,1,63,5790
2023-08-29,22374,16673,Finance,East,1,7,5701
2022-11-29,41012,13725,IT,East,6,111,27287
2022-09-24,28523,25844,Marketing,North,7,130,2679
2022-03-30,34783,17654,Sales,South,9,449,17129
2020-07-28,25563,28895,Sales,South,5,132,-3332
2020-09-28,20042,14965,IT,East,1,8,5077
2023-03-05,32820,12508,Finance,East,9,382,20312
2021-08-21,41252,24037,Sales,North,5,305,17215
2022-12-19,12208,20091,Operations,East,6,29,-7883
2022-11-04,23796,7570,IT,North,9,338,16226
2022-10-19,48390,27132,Marketing,South,2,311,21258
2020-09-11,35426,5264,Marketing,West,3,421,30162
2022-01-06,32670,24979,Marketing,South,7,351,7691
2021-12-22,34320,21025,Sales,West,3,6,13295
2021-06-18,30074,18349,IT,West,2,492,11725
2023-06-12,37931,23418,Marketing,West,7,408,14513
2023-02-28,28993,24586,IT,East,8,112,4407
2022-10-20,42991,13573,Sales,North,9,105,29418
2020-01-17,25003,16488,Operations,West,2,207,8515
2022-05-31,24743,14358,Operations,North,2,40,10385
2022-08-11,24007,15670,Operations,South,7,268,8337
2022-04-05,34300,5388,Sales,West,4,320,28912
2022-09-18,26175,27581,Marketing,South,5,46,-1406
2022-05-27,15973,7071,Sales,North,1,241,8902
2020-07-03,19703,29970,IT,North,6,270,-10267
2023-11-15,42313,19968,Operations,South,8,155,22345
2023-12-17,28470,19454,IT,North,1,116,9016
2022-11-01,39176,12840,Sales,South,2,37,26336
2020-03-20,33280,16849,HR,North,7,205,16431
2022-03-19,33867,24640,HR,East,2,249,9227
2020-10-28,31845,25403,Sales,South,9,486,6442
2023-05-24,26241,15431,Marketing,West,6,110,10810
2023-06-25,45055,27442,Finance,West,5,486,17613
2023-07-19,18878,11630,IT,West,7,318,7248
2020-05-12,20209,19968,Sales,North,8,323,241
2022-10-25,38499,18008,Sales,South,9,80,20491
2022-01-25,47603,19719,HR,North,6,76,27884
2021-09-20,45302,7859,Operations,West,5,270,37443
2022-10-06,21004,7393,Operations,East,7,98,13611
2022-02-11,40587,28203,Finance,West,2,498,12384
2020-05-20,43390,19091,Marketing,West,8,479,24299
2021-04-27,38400,27455,Marketing,West,4,423,10945
2023-08-21,20975,7050,Finance,East,1,389,13925
2020-12-10,22585,8121,Marketing,East,3,76,14464
2023-07-17,16876,14116,HR,South,9,282,2760
2023-02-05,23599,9971,Sales,East,4,81,13628
2021-04-18,35239,16767,Marketing,South,3,364,18472
2023-01-10,30378,29079,HR,East,4,309,1299
2023-01-12,36568,8354,IT,South,3,63,28214
2023-08-06,41510,9474,Sales,West,3,267,32036
2022-12-30,45462,8397,Finance,East,2,33,37065
2020-06-23,30688,26801,IT,North,6,297,3887
2022-04-21,31796,25152,Operations,North,6,40,6644
2023-11-19,40796,11281,Operations,South,4,174,29515
2022-05-15,30817,17412,Sales,East,8,260,13405
2023-01-19,20061,24365,Marketing,East,6,224,-4304
2021-04-13,34401,20751,Sales,North,8,223,13650
2023-12-28,13810,10521,Marketing,East,6,267,3289
2023-06-26,43680,8472,Finance,East,9,465,35208
2021-10-05,33826,24001,Operations,South,3,155,9825
2021-11-11,14902,10481,Sales,West,3,264,4421
2022-08-12,29612,11209,Sales,North,2,149,18403
2022-04-28,20663,24883,Finance,West,6,225,-4220
2020-08-28,23967,28379,Marketing,East,7,383,-4412
2021-12-02,15135,29265,Operations,East,7,498,-14130
2020-12-05,24072,24976,Operations,South,5,127,-904
2022-03-03,30417,13623,Marketing,West,6,5,16794
2022-01-13,16443,27438,Finance,West,7,446,-10995
2021-04-07,47610,28656,Marketing,South,2,288,18954
2022-03-11,31925,14304,Finance,West,7,345,17621
2023-07-22,40002,26080,Marketing,South,1,58,13922
2020-01-15,46795,18143,Operations,South,6,72,28652
2022-11-30,40993,15245,Operations,East,8,155,25748
2020-07-26,10260,17445,Sales,East,1,282,-7185
2022-12-19,19127,12546,Finance,East,1,168,6581
2020-12-30,46978,27857,Operations,South,6,29,19121
2023-06-17,34843,26606,Finance,East,5,457,8237
2021-08-30,42840,23833,Finance,North,3,82,19007
2020-06-08,47879,10802,IT,North,7,263,37077
2021-01-31,12921,5544,IT,East,7,106,7377
2022-03-04,13888,11652,Marketing,South,7,277,2236
2021-05-14,10177,21052,Finance,North,6,464,-10875
2020-07-27,17426,27711,Marketing,East,4,451,-10285
2023-03-02,14495,28442,Marketing,North,9,352,-13947
2023-11-05,43037,7628,Sales,North,9,10,35409
2021-03-08,20047,8451,IT,North,7,62,11596
2021-08-31,28039,13729,IT,West,7,224,14310
2021-01-23,45301,6436,Operations,North,8,136,38865
2022-09-23,31366,29471,IT,East,5,224,1895
2021-08-05,30745,28045,Operations,North,9,114,2700
2021-03-07,21353,16007,Finance,East,6,260,5346
2023-07-21,35080,8062,Sales,North,7,157,27018
2020-12-16,28788,21643,Marketing,North,7,396,7145
2020-05-13,44969,12551,Marketing,West,9,229,32418
2022-12-25,15659,18113,Finance,North,7,100,-2454
2021-09-30,43921,20663,Operations,East,3,255,23258
2023-05-13,14161,9411,HR,West,6,179,4750
2023-08-14,25503,9841,Finance,West,6,275,15662
2020-04-26,37003,12961,Operations,North,7,229,24042
2023-07-14,34982,22102,Finance,North,6,367,12880
2020-05-28,13478,10196,Sales,South,4,31,3282
2023-05-02,38620,24111,Finance,North,6,108,14509
2020-06-27,45129,16093,Finance,South,3,282,29036
2020-05-27,37172,12546,IT,East,1,109,24626
2021-04-09,20160,24238,Operations,North,1,390,-4078
2022-09-02,45214,26584,Sales,North,5,29,18630
2021-07-22,21931,25451,Marketing,South,8,17,-3520
2022-10-25,41170,24361,HR,South,3,404,16809
2021-06-09,41190,19484,HR,West,2,170,21706
2020-10-06,17601,20103,Operations,West,8,366,-2502
2021-05-13,47819,19680,Finance,North,9,175,28139
2022-04-15,13517,19101,IT,East,9,74,-5584
2021-03-11,14802,15006,Finance,West,2,454,-204
2022-03-26,28759,8480,Operations,West,8,240,20279
2023-05-24,17850,14933,HR,West,2,96,2917
2021-11-17,16744,18261,HR,South,7,2,-1517
2022-04-07,32773,18209,Finance,North,8,202,14564
2022-08-26,16248,13221,Finance,South,1,37,3027
2023-03-06,17136,20065,Finance,East,8,91,-2929
2021-09-03,21800,24877,Marketing,South,3,233,-3077
2021-08-17,23417,5230,IT,North,1,147,18187
2023-07-27,35305,12526,IT,South,7,499,22779
2020-05-11,46735,10281,HR,East,3,297,36454
2021-01-27,47719,6251,HR,North,8,400,41468
2021-04-25,14002,26724,Operations,North,9,253,-12722
2021-09-19,12332,11889,Operations,North,2,371,443
2021-02-22,36149,18384,Marketing,North,1,212,17765
2023-05-10,14375,17686,HR,East,8,444,-3311
2021-10-13,39458,23347,Operations,North,6,441,16111
2021-10-19,43453,24550,Marketing,East,1,484,18903
2021-04-06,30272,6778,IT,East,3,64,23494
2023-05-10,27352,13052,HR,South,9,5,14300
2020-05-31,12033,9870,Sales,South,9,146,2163
2020-08-09,49843,6147,HR,North,6,72,43696
2020-03-19,31645,7847,Operations,West,3,397,23798
2023-05-08,35343,25234,HR,West,8,105,10109
2020-04-08,10645,24454,Sales,North,6,330,-13809
2022-06-30,41775,5620,HR,East,1,36,36155
2020-07-31,14121,5963,Operations,South,6,147,8158
2023-03-12,18112,12215,IT,North,5,415,5897
2021-12-02,19271,16052,Operations,North,8,256,3219
2023-11-13,49204,23526,Marketing,East,2,228,25678
2023-10-29,35212,21003,Operations,South,7,349,14209
2022-12-11,20292,12418,Marketing,West,6,365,7874
2022-08-24,33481,22710,HR,West,1,279,10771
2020-05-14,48354,5121,Marketing,North,8,416,43233
2021-02-14,38493,9313,Finance,North,6,113,29180
2023-02-09,39475,22460,HR,North,3,11,17015
2022-02-23,10868,22566,Marketing,North,5,194,-11698
2022-12-03,48682,18982,Operations,North,7,224,29700
2023-11-21,18213,5794,Sales,West,9,250,12419
2020-09-17,32739,14816,HR,North,4,389,17923
2022-01-12,11903,25655,Marketing,South,2,249,-13752
2021-06-28,45344,13483,Sales,East,3,351,31861
2021-01-22,46877,12326,Marketing,West,7,269,34551
2023-12-04,30998,13682,Marketing,East,8,342,17316
2020-01-16,28319,24192,Marketing,East,5,448,4127
2021-10-23,43383,24812,Operations,North,3,291,18571
2020-04-11,31441,18548,Marketing,East,1,83,12893
2023-04-24,20642,24883,Sales,South,1,29,-4241
2022-08-08,21776,23556,Finance,North,2,407,-1780
2022-07-19,34862,20638,Marketing,West,5,339,14224
2020-01-25,41103,10986,Finance,South,3,80,30117
2022-12-31,21510,8907,IT,West,7,95,12603
2020-01-18,44691,26083,HR,North,2,400,18608
2021-07-23,23402,12081,Operations,North,2,410,11321
2022-10-13,16455,26608,IT,West,3,259,-10153
2023-09-17,12773,18353,IT,East,1,122,-5580
2023-01-25,37377,24852,Sales,West,2,124,12525
2022-04-10,19776,10760,Sales,South,5,23,9016
2022-11-01,42059,18771,Finance,East,3,441,23288
2022-10-31,39405,5490,Finance,North,6,393,33915
2020-06-11,10143,9263,Operations,South,2,435,880
2023-07-30,35698,12769,Operations,South,8,216,22929
2022-05-21,27083,22581,HR,North,4,289,4502
2022-04-14,32702,16635,Marketing,East,3,462,16067
2023-06-18,43038,6904,Operations,North,5,92,36134
2022-05-06,11007,10269,Operations,South,8,24,738
2022-12-04,37419,6650,Finance,South,9,107,30769
2022-08-27,20174,17467,Marketing,South,1,306,2707
2021-08-15,40880,8191,HR,North,4,52,32689
2020-09-11,17203,5027,Sales,West,6,199,12176
2020-03-07,46492,19132,HR,South,6,294,27360
2022-07-06,38989,27644,Marketing,South,9,300,11345
2021-09-05,37331,7750,Sales,East,1,345,29581
2022-08-31,32983,7879,Sales,West,5,382,25104
2021-08-25,39735,9357,Sales,East,1,56,30378
2022-12-01,30893,15865,HR,South,6,194,15028
2021-01-18,25739,21255,Finance,West,9,45,4484
2023-06-11,39917,7832,Marketing,East,4,436,32085
2022-08-23,30704,8109,HR,North,9,385,22595
2021-04-29,40152,14652,HR,East,3,343,25500
2020-02-08,48240,10758,IT,West,7,239,37482
2020-01-11,17206,7921,Operations,East,5,372,9285
2021-09-15,33256,6433,HR,West,1,232,26823
2021-02-12,34307,9428,IT,West,7,466,24879
2020-04-17,14716,12698,Finance,East,8,320,2018
2023-01-22,45388,13111,Finance,East,6,239,32277
2020-03-24,28920,24920,Marketing,North,1,392,4000
2020-02-27,47871,28247,IT,East,9,482,19624
2023-08-09,33464,22565,HR,West,7,427,10899
2022-11-05,48085,20519,Marketing,South,6,136,27566
2022-09-17,23587,24789,IT,East,4,285,-1202
2022-04-17,11195,20735,HR,East,3,13,-9540
2021-08-27,35083,17366,Marketing,West,4,385,17717
2022-08-26,32438,19155,Marketing,South,1,29,13283
2020-06-13,30009,25298,Operations,North,9,178,4711
2021-03-12,45587,17484,Finance,South,2,293,28103
2021-12-27,31143,14975,HR,West,2,257,16168
2021-02-06,23696,25106,Operations,West,3,108,-1410
2023-11-10,17564,17513,Marketing,West,1,69,51
2023-03-07,13637,7642,Marketing,West,3,373,5995
2021-12-16,44641,12577,IT,South,4,176,32064
2022-03-24,27790,18849,Operations,South,9,183,8941
2021-12-22,38159,8711,Sales,South,5,242,29448
2021-06-14,15514,24344,HR,East,6,194,-8830
2020-10-19,44345,26214,Finance,West,1,367,18131
2022-10-19,31763,10458,Operations,East,3,319,21305
2021-04-06,22568,23003,Marketing,East,7,22,-435
2023-10-28,38003,27522,IT,East,7,350,10481
2023-03-31,15311,11680,HR,North,1,11,3631
2021-10-03,48315,17507,Finance,East,9,285,30808
2020-02-13,27191,23724,HR,West,1,362,3467
2023-01-11,30908,14419,IT,East,7,259,16489
2022-06-10,11415,21239,Marketing,West,2,173,-9824
2021-09-27,28833,23112,Finance,North,9,205,5721
2021-06-22,25406,24969,Sales,South,9,248,437
2022-05-11,39336,21585,IT,West,9,259,17751
2021-06-02,39421,10985,Sales,East,4,330,28436
2023-12-05,46264,27559,Operations,West,6,452,18705
2023-09-26,21780,8160,HR,East,2,270,13620
2021-12-11,49871,16465,Finance,South,3,471,33406
2020-03-29,22221,23097,Marketing,West,6,81,-876
2023-06-07,31116,12872,Sales,East,1,321,18244
2022-11-07,49790,12839,Marketing,West,7,441,36951
2021-11-03,24422,20652,Operations,South,2,399,3770
2022-05-13,31483,11859,Sales,South,8,188,19624
2022-06-08,15416,5752,Marketing,South,5,438,9664
2023-07-28,25251,18304,Marketing,West,7,373,6947
2021-02-25,37074,21498,Operations,West,8,386,15576
2022-05-25,22164,20057,IT,East,3,338,2107
2021-12-02,12468,26725,Finance,South,6,448,-14257
2020-12-03,12027,8980,Operations,East,9,231,3047
2020-09-22,33555,11325,Sales,West,4,470,22230
2022-03-13,21944,24202,Sales,North,7,28,-2258
2023-10-10,10315,21852,HR,South,1,350,-11537
2020-12-25,24133,5425,Marketing,East,7,461,18708
2022-10-10,46757,13141,Finance,South,9,323,33616
2020-08-04,43298,22959,Sales,East,8,3,20339
2020-11-16,34268,15057,IT,East,4,237,19211
2022-04-29,14757,22217,IT,North,3,181,-7460
2021-12-19,39967,19316,Operations,West,7,410,20651
2022-09-18,35795,19820,Sales,South,1,4,15975
2023-05-20,38798,9106,Finance,West,8,400,29692
2022-08-10,43835,25087,Finance,East,1,348,18748
2023-05-11,41461,6408,Sales,West,7,72,35053
2021-12-17,43495,24865,HR,North,6,182,18630
2022-09-11,26627,27569,HR,West,8,104,-942
2022-06-14,36361,10821,HR,East,6,272,25540
2023-03-22,10711,15362,Sales,East,5,287,-4651
2023-12-23,21085,11844,Operations,North,9,87,9241
2020-10-13,37726,11395,Finance,South,4,386,26331
2022-01-26,17924,13795,Operations,North,7,73,4129
2023-09-06,25549,20843,Operations,South,6,91,4706
2023-12-30,18462,21596,Operations,East,6,173,-3134
2021-05-10,12560,27795,IT,West,5,310,-15235
2023-03-18,31523,20341,Sales,East,2,187,11182
2021-06-25,29944,9801,Marketing,North,4,443,20143
2021-09-26,12177,20346,Sales,North,1,406,-8169
2023-09-11,30098,6758,Operations,West,9,236,23340
2022-07-27,45846,10780,IT,North,9,162,35066
2022-11-18,37475,16260,IT,East,8,73,21215
2023-07-06,42447,13973,Sales,West,4,225,28474
2021-11-28,31416,17413,Marketing,South,5,384,14003
2020-03-15,24120,22910,Operations,North,1,230,1210
2021-05-12,12948,5840,IT,South,4,254,7108
2023-12-10,12520,22725,Operations,West,4,440,-10205
2021-12-22,17269,17299,Operations,North,5,162,-30
2023-09-25,36961,22884,Finance,West,2,355,14077
2020-11-03,23336,29505,Operations,North,2,250,-6169
2021-12-04,24020,10559,HR,North,2,495,13461
2022-06-02,37280,10926,Finance,North,8,410,26354
2023-06-18,26746,13707,Operations,West,2,199,13039
2020-09-09,12256,21175,Operations,West,6,429,-8919
2022-07-24,37712,16654,Marketing,East,2,240,21058
2023-05-28,22836,18991,Finance,East,8,237,3845
2021-01-31,35711,16271,Finance,West,1,475,19440
2022-09-12,14358,12675,Marketing,West,2,76,1683
2023-09-21,21339,14339,HR,North,5,465,7000
2022-11-18,42039,27841,Finance,East,6,405,14198
2021-05-08,31245,24640,HR,East,9,427,6605
2022-08-16,27259,7594,Operations,West,6,342,19665
2023-03-23,17129,8656,IT,East,8,474,8473
2022-09-18,21211,14740,IT,West,7,295,6471
2023-06-08,40197,23470,Sales,East,1,397,16727
2020-04-11,25628,8155,IT,South,2,490,17473
2022-04-06,36300,28572,IT,South,4,426,7728
2020-06-25,27512,27780,Marketing,East,1,45,-268
2022-09-10,30945,5978,Sales,West,8,343,24967
2022-07-15,43787,15497,Sales,South,4,179,28290
2020-08-19,31408,17075,Marketing,North,7,222,14333
2020-01-12,30311,24431,IT,West,7,375,5880
2023-04-24,45609,7589,IT,South,8,17,38020
2022-01-30,21139,23390,Sales,North,9,219,-2251
2022-07-20,48245,28167,IT,South,9,84,20078
2020-09-22,27610,10942,Sales,South,7,191,16668
2023-03-04,38952,23983,IT,North,9,391,14969
2022-01-26,23568,7508,Operations,North,5,439,16060
2022-11-20,34899,17511,Marketing,East,4,132,17388
2021-03-31,22002,29855,Finance,South,3,497,-7853
2020-09-15,17529,22577,HR,North,6,287,-5048
2023-02-01,28069,10915,Operations,East,9,94,17154
2021-03-06,13712,7045,IT,North,4,95,6667
2023-11-06,49826,29180,HR,East,2,184,20646
2021-04-13,29328,13439,Finance,East,3,132,15889
2023-05-15,27711,14576,Operations,North,3,82,13135
2021-10-08,15906,14564,Finance,North,2,340,1342
2021-03-22,39107,16105,Marketing,South,9,296,23002
2022-02-21,27813,28986,HR,South,4,360,-1173
2023-01-17,19153,20765,Finance,East,3,112,-1612
2020-07-13,41679,25056,HR,North,6,303,16623
2023-12-08,39588,19793,Marketing,South,8,306,19795
2023-02-19,33770,19921,Finance,East,8,407,13849
2021-04-06,28852,12181,Operations,South,6,51,16671
2023-02-13,29612,5044,HR,East,5,294,24568
2020-07-14,40907,23469,Finance,South,7,393,17438
2020-02-05,40171,9511,Marketing,North,3,189,30660
2020-03-07,25448,27772,Finance,West,2,208,-2324
2021-10-06,13966,20421,Finance,West,8,149,-6455
2023-07-28,31401,12775,Operations,East,9,265,18626
2022-10-31,31539,26755,IT,West,6,372,4784
2020-11-17,44018,15707,Sales,West,4,281,28311
2020-08-27,14688,18372,IT,East,6,113,-3684
2022-10-13,30457,12948,IT,West,7,36,17509
2022-12-19,46555,27607,Sales,South,8,111,18948
2021-10-11,41379,25707,Finance,South,3,171,15672
2021-07-15,20470,28010,IT,South,6,78,-7540
2020-06-13,48426,29433,IT,North,6,337,18993
2022-04-10,19193,28475,Marketing,South,7,28,-9282
2020-07-07,44980,16079,Marketing,West,4,448,28901
2020-04-01,49635,13216,Operations,West,6,45,36419
2020-10-15,49731,15006,HR,South,2,361,34725
2023-01-03,32077,6225,Finance,North,8,440,25852
2023-12-22,46759,6248,Operations,South,3,304,40511
2023-11-09,19295,20869,Marketing,North,9,392,-1574
2022-12-12,24735,26410,Marketing,North,8,142,-1675
2020-06-23,13032,24226,Sales,South,6,15,-11194
2021-04-18,46671,10698,Sales,North,2,128,35973
2023-10-16,39897,22966,Marketing,West,8,167,16931
2020-09-26,35836,9848,IT,South,6,153,25988
2021-02-10,46438,14905,Operations,West,1,63,31533
2023-02-21,31278,16783,Marketing,North,6,59,14495
2021-11-24,31902,18388,Finance,East,5,203,13514
2021-01-10,46091,8138,Marketing,South,6,157,37953
2023-11-16,17120,26139,Sales,East,1,3,-9019
2020-06-30,17859,22901,Operations,East,4,39,-5042
2020-02-05,42867,15924,Operations,East,7,278,26943
2023-05-20,40611,9642,HR,East,5,101,30969
